Strand-Sequence-001	ACATCCAACACTCTACGCCCAACAACAACAACAACGACGAAGAAGGTTAGTTAAGAAGAACCTAAGTCGCTCGGAGAAGACTAGAAGACGCGTCGTAGAAGTAAGGTACCGGACGCGCTCGCGCGACTCAAGACCTACAACGCTAAGCCGCCTCGACTAACGCGAGTCGGACTCGCAAGAAGACGTAGGAAGGCGGTCGGTAACTACAACGAAGTACCTAGTTCAACGGCGAATAGGAGCCGCAACACAC
Strand-Sequence-002	ACATCCAACACTCTACGCCCAACAACAACAACAACGTCGAAGGTTCGTACGTCGAACAAGAAGACTACTAGTTCGGTTCGAGTACGAGAAGACGCCTCTAGAGCTACGGTCTCTAACTACCTAGTACGAGTTAAGCGAGGAGAAGGAGTTACGGCGGAAGCGCCAACGGTAGTTAGGAAGAGTCGAGTTACTAGTCGAGGACGTACCTACTCTACTAGGAAGAACTAGAAGAATAGGAGCCGCAACACAC
Strand-Sequence-003	ACATCCAACACTCTACGCCCAACAACAACAACAACGCCGCCAACGGCGGCAAGTCGACGAGTACGAAGTAAGACGCTCAAGACCTCCTCCTCTCGACGAGCCTAAGAACGTAGAGAAGGAGAACCGCGTCGTCGTTCTACGCTACTAGCCTAACTCTCAACTCGGAACTCTAGTTCGGCAAGTAGACTCCTAGCTCGTCGTACGGACGCTAGTAAGACGAACTACGAAGAGAATAGGAGCCGCAACACAC
Strand-Sequence-004	ACATCCAACACTCTACGCCCAACAACAACAACAACGAAGAAGACAAGTTAACTAAGACTAGAGACGGAGAAGCCTAGACCTACTACGTCGGACGCAAGTACGGCTACGTCGCCGGAACTAGGACCGTTACGAAGGAGTAGAGCAACGAAGCGAGAAGTAGAACGCGCGGAGACGGACTCGGCAACGGACAAGGCCGGTAGACGTAAGAAGCGACGAGACAAGAGTAGGAAGAATAGGAGCCGCAACACAC
Strand-Sequence-005	ACATCCAACACTCTACGCCCAACAACAACAACAAGACCGCTAACTACTACGAACTCGAACAAGTCTACGCGACCGGCAAGAGTTAACTCTAAGACAACTAGAACAACTAGAGCGCTAGACCTCTCTCGACTAGACGCAAGACCTCGGAAGACTAGTTCAACGAAGCGAGGACCGTAACTAGAGACCTCGCTACTAGTTAACCTAGTCGGAGGTACAAGACCAAGAACTCGGAATAGGAGCCGCAACACAC
Strand-Sequence-006	ACATCCAACACTCTACGCCCAACAACAACAACGTCGAAGGTAACTAGTACGCCAAGGAACCTCCTAGCGAAGGCCTACTCGAACGCGGCGGTAAGACTCGGTCGAACGCTACCGCCAAGAAGTACGGTAGTAACTCGAACGAACGCGGAGAAGAACAAGTCAAGTAAGGAACCGCTCTCTACGTCGCCTAACCTCCTACTCGCTCGAGGTTAACTCTCGGTTCGAGCAACGAATAGGAGCCGCAACACAC
Strand-Sequence-007	ACATCCAACACTCTACGCCCAACAACAACAACGAAGAAGACAACTAAGCGAGCGCTCGCGTCTAACGACAACCTCCTACCGGAAGAGGACAAGCGACGAGCAAGAGCGCTCCTCCTAGTAGACCTACGGAAGTCTCGTCGAGTAGGTCGTTAGAAGACCTCAACTAAGGATCGTAAGCCAACCTAACGAGCGGCCTCAACTAGAGAACGTCGGAACAACGAGAAGGAAGCGAATAGGAGCCGCAACACAC
Strand-Sequence-008	ACATCCAACACTCTACGCCCAACAACAACAAGACCGCTAACAACCTCTACGTCGCGACCGCGTAAGTCTAACGCTACGTCGTCGCCGCTCTCGCGAGGTTAAGACTAAGCTCGAAGACGTTAAGGAGAGACTACCTACTCCTCAAGAGTACCGTACGACAAGACTAACTCTACGAAGTCGCTCGCCTCCTCTAAGCGAGGAGCGGTAACGCCTAGTTACAACCTACCGCGGAATAGGAGCCGCAACACAC
Strand-Sequence-009	ACATCCAACACTCTACGCCCAACAACAACGTCGAAGGTAACAACGGTAAGAGGTAGTAAGCCAAGTCGTTCGCCGAACCTAAGAGAAGTAAGTCGTAGACTCGGAGTTCGAGAAGGACGAACAACGCTCAAGAGAGACTACGAACGAAGAAGTTACGCGCCTCGACTCGCCTCGCTCGAAGTAGTAGAACTAGAACGTAGACCTAGAGTCGGTAAGCCTAACAAGTCCTAGAATAGGAGCCGCAACACAC
Strand-Sequence-010	ACATCCAACACTCTACGCCCAACAACAACGAAGAAGACAACAACTAACAACGACGCCTCCTCGTCAAGAAGAGCTAGTTAACGAAGGAGACTAGCTAAGGACCTCGACTCAAGACTCTCAACGGCGCGACCGTTAGTCTACGCGGCTACTACTCGAAGTACGCTAGAACTCCTCTCGTCCTCGAAGGACAACAAGTTCCTCTCAAGGAAGCCGTTACCGCTACCGCTCGGGAATAGGAGCCGCAACACAC
Strand-Sequence-011	ACATCCAACACTCTACGCCCAACAACAAGACCGCTAACAACAACTAGTAAGGTTACTAGAGTCTACAAGGAAGGTTAACTCGCGGAAGTAGGAACTACGGAAGCTAGAAGAGAAGTTACGAAGAGGAAGCTAACGAAGGAAGGAGAGACGCTAGTACCGTTAGTACTAGCTCGAGCAACGCTCGAGTCAAGACTAACTCGACGTTAAGCCTAGACGTCGCGTCGAGCGGAGAATAGGAGCCGCAACACAC
Strand-Sequence-012	ACATCCAACACTCTACGCCCAACAACGTCGAAGGTAACAACAACGGTACTCGGCGGCGGTACGGACAACTCGGACAAGGCTAGTTCGAAGCCTAGACGTTCTCGACTACGAGTAACAAGAAGAGGTAACGAAGACTCGCCGAAGAGACGAGGTCGAACGACGGTTAAGCTACGACCGTACGCGCGTTCGGAACTAGTAGGCGGAGCGGCTCTAGAGACGCTCTACGAAGAGAATAGGAGCCGCAACACAC
Strand-Sequence-013	ACATCCAACACTCTACGCCCAACAACGCCGCCAACAACAACAACGCTAGTACTACGAACGGCGAACTCAAGAGTCTCTAGACTACCTACAACAACTAGAACGTCGCCGCGGAACAAGCTCAACCTCGCGGAAGGTTCGTCCTAAGTAACTAACGAAGAAGACAACGCGAAGAACGCGCGAGTAGTTACTACGCCGGTTCGAACTAAGAAGTTAACTACGCGAACTAGGAAGAATAGGAGCCGCAACACAC
Strand-Sequence-014	ACATCCAACACTCTACGCCCAACAACGAAGAAGACAACAACAACGGCGCTAGGTACTACGGAGAACTCGGCGGCGGCGCTCGAACTACCGTACCTAGAAGATCGACGAGAACTACTAAGAGGAAGTTAACTAGGACGACGACGGAAGGATCGTTACTACAAGCCAAGTACCTACGCGGTACGAGGTCGTTCTCGACGTCGAGTAGAACTCGCCTCGCTAAGTAAGACAACGAATAGGAGCCGCAACACAC
Strand-Sequence-015	ACATCCAACACTCTACGCCCAACAAGACCGCTAACAACAACAACAAGAGTAGATCGTTAACCTCGACTCTACGACGCGGCGCCTAAGAAGGTTCGGAACAAGGCGGTAGACGCGCGTCGACGACCTAAGGCCTACGCCTAGAGTACTACGCCGGCTAAGTCGCTAGACTAGAGAACGGTAGGACGGAAGCGAAGTCGTTAAGAAGTCGGAGCTCGTTAACTAAGTACGGTGAATAGGAGCCGCAACACAC
Strand-Sequence-016	ACATCCAACACTCTACGCCCAACGTCGAAGGTAACAACAACAACGGCCTAACGACTCGCCTAACTCAAGACGCCGTTAAGTACCTAAGACTAAGAAGAACGGAAGAGAGCGGTTAGAGTACTACGTTCGCCGGAGAGTACCTCTACGTCTACGGAGAAGCTCGGACCTCGTTCGGCGCTACCGAAGCGAGCCTCAAGAGACAACAACTCGGTCTCCTACCTCTCCTACAAGAATAGGAGCCGCAACACAC
Strand-Sequence-017	ACATCCAACACTCTACGCCCAACGCCGCCAACAACAACAACAACGAAGCGAAGACCTCGTTCCTCCTCTCGTCGAGTAGGAAGACGTAAGACTAGAGGAGGAGAAGCTAAGCCGTCTACGCCGAAGAACGAAGAACGACCTAACTCTCGTTAAGAGAAGACGGACCTACCAACCTCGCCGTCGGTAGGTAACTCGGCGGTTACCTACTCGGCGTCGGTCTACGAGACTAGGAATAGGAGCCGCAACACAC
Strand-Sequence-018	ACATCCAACACTCTACGCCCAACGAAGAAGACAACAACAACAACTAAGGTAGCGAACCTAGACAAGCCTACGCGAACGTCTACTCGGAAGGTCGGAGTCTCGCCGAAGCTCCTCAAGCTCAAGCCTAAGAACGCTAGAACTAGGAAGAGAGAAGCCTCCGTCGGTCGTTCTACTACTCGAGGTCGTACGGAGAAGTCTAACAAGGCCTAAGAACTCTAAGCTCGAGGTAGGAATAGGAGCCGCAACACAC
Strand-Sequence-019	ACATCCAACACTCTACGCCCAAGACCGCTAACAACAACAACAACGCCTCGAGGACGAACTACAAGTTCGCGAGACCTACCGTAGAGGAACGAGAACGACGCGCTCTAACTACCTAACCTAGTCGGACTCGACGCAACTAGAGAAGAACGTTCGCCGCTAAGAACGCGACCAAGAGATCGTCGGAAGTCTACGCTACGACGTCGACTCGGACTCGGCGGTCGAACGCTAACGAATAGGAGCCGCAACACAC
Strand-Sequence-020	ACATCCAACACTCTACGCCCAGGCGGAGTAACAACAACAACAACTAAGAGAGGACCTCGAGGTTCGCCTAAGGTAGTAGTCTACTCGCTCGGTCGGAAGAAGCCGTAACGGAACAAGCCGGCGAACGAAGTAGGTTCGGCGGTTAGACCGAAGACGAAGCTAGAAGGAAGAGCGGAGAAGCCGTTACTAGGAGTTACAACTCGTAAGCCTACTAAGTCGAAGCGTAGAGCGAATAGGAGCCGCAACACAC
Strand-Sequence-021	ACATCCAACACTCTACGCCCACCGCCAACAACAACAACAACGACGTCGCGTTCGGTAAGGAAGGCGAAGACGTCAAGACTACCTACAACCTAAGAAGGTCGTCGACGTTAGAAGGAAGCTCGAGAAGGTAGAGGTAAGAGAGCGGAACCAAGTCGTAGTACGAAGCGTAGAGTAGGAGCTACTCGTAACTAACTCGGACTAGTAGTAAGAGGAGTCGGTAGAGCTAAGCCGAATAGGAGCCGCAACACAC
Strand-Sequence-022	ACATCCAACACTCTACGCCCGAAGAAGACAACAACAACAACAACGCGTACCTCGCCGTCCTAAGCGAAGGTTAAGTCGTCGCGAAGACCGCCGTCGTCTAAGAAGCGACTAGGACCGTACCTCCTCTACTCAAGAGCGCTAAGAAGGCCGCCGTCGCCGCGAAGAGAGAGTTACGCGCCTACTCGTTACCTCCTAGAGAACAACCTAGCGTAGAAGTCCTCTAGGAAGACGAATAGGAGCCGCAACACAC
Strand-Sequence-023	ACATCCAACACTCTACGCCCACCGCTAACAACAACAACTACGCCGAAGGAACCGGAAGACCTAGTCTAGAAGCGACGTTCCTCGCGACTCGGTAACGAGAAGAGTCGACCGCGACTACTCAAGAAGCCTCGTTCGCGTTAACGTAAGGCGTCGGAAGCGCGAAGTTCTACTACTCGTCGCGGACGAAGAAGTAAGGTAACGGTACCGGCGAAGGTAGCTAGGAAGCTAGTGAATAGGAGCCGCAACACAC
Strand-Sequence-024	ACATCCAACACTCTACGCCCGAAGGTAACAACAACAAGAGTCGGACCTAACTACAACGAAGTAGCCTCCTCGTCGCTCGACTCCTCTCTAGCTACGTCTAAGGTAGGACGTTCGGAGACGGTAAGTTCGTCAACGGACAAGAAGTCGGTCTAAGTAGTAGAACCGTTAGATCGAAGAGAAGGAGTTAGAACGGACGCCTCAACTACTACTAGACGTTCAACGCTCGACTAGAATAGGAGCCGCAACACAC
Strand-Sequence-025	ACATCCAACACTCTACGCCCACCAACAACAACAACTCGTAGAAGTAAGCCGGAGACGGTTCGAGCGTCTACTACTACGCTCGCGAAGAGACCGAAGGTCTAACGAGAAGAAGCGAAGAAGTCGCCTACGGAAGGTTAAGAACTACCGTACGAACGTCGACTACGAACTAGTCGAAGTAAGCTACCTCGAGAACCGGTACGACCGTAAGAGACTCGTTAGACTAGTTCCTAGAATAGGAGCCGCAACACAC
Strand-Sequence-026	ACATCCAACACTCTACGCCCGAAGACAACAACAACGGAGAAGTCGTCGAAGTCTAACGCGCCGCCGCTACCGGAACGACTAGTCTCGGCTCGTTCGGCGAACTCAACAAGACTCGACTAAGTACGTCGAAGAACGCTCCTCAAGGCGTCCTCGCGTTCGAACGCAAGAGGTCGTACCTAGAACGCCTCTAGTTACTAGAGACTAACGCGAACTAGGAAGGAAGGAGCAAGGAATAGGAGCCGCAACACAC
Strand-Sequence-027	ACATCCAACACTCTACGCCCACTAACAACAACAACCTCGGTAAGTTACGCGGTTCGAACAAGTAACTAAGTAGGAACGAAGCTAGTAGACTCGGAGACTAACCTCTCGCTAGAAGTCTAACCAACGCCTACTCGTCGAGTACTCTAAGCGGTCGGCGGAGTCGGAACGCCGCGAGGAGTAGAAGAACTAGCTACCTAGACTAGACTAGAACCGTCGGACCTCAAGAAGGTGAATAGGAGCCGCAACACAC
Strand-Sequence-028	ACATCCAACACTCTACGCCCAGTAACAACAACAAGTTCAACGTCGCTACGACCGCTCCTCTCGTCGTCGCCTAAGACAAGACCGAAGAGGAAGAAGCTCGCTACCTCGGACAACTAGAGAGTTCGAGCTAGACGAGCCTCTAAGCTCCTAGATCGAAGTCGACTAGCGGCTCGACTCGAGAACAAGACCTAAGGACGACGGAAGAGACCGTTCGAAGTTCGTTAGACTAGGAATAGGAGCCGCAACACAC
Strand-Sequence-029	ACATCCAACACTCTACGCCCAACAACAACAACTCGTTACCTAAGTAAGCCTAGTAGACCGCTAGAAGAACGACCTCGAGGTAGACTAGCAAGAACGTCGGTCTCGCTCTCGTCTCGTTAAGTCGGTACTACGTCGCGTTACCTCAACAAGGTTCGAAGACGTACTAGTACGGTCTAAGTCTAACCGTTCGACTCTAACCTACGAGTAGCAAGTTCGGCCTCGGAAGAAGAGAATAGGAGCCGCAACACAC
Strand-Sequence-030	ACATCCAACACTCTACGCCCAACAACAACAACGGACGCGGTAGGACTACGTACTAGAAGTTCCTCGAAGAACGCGGCGAACTCGTCCTAAGGTCGTAACTACTACAAGCTAACTCGAGAGAAGAAGGTACGAGGTTACTCTAACCTAGGACTCGACGCGGCGGCTAAGGCCTCGGAACGTTACTACGAAGACTAAGCAACGCTAGGTAGAACCTAAGCTAAGCGACCGGAGAATAGGAGCCGCAACACAC
Strand-Sequence-031	ACATCCAACACTCTACGCCCAACAACAACAACCTCTAAGACGCTCTCTCGTCGAACGGAGAACCTACGAACGTCAAGAGACTCGCTCGACAAGCGAGTCTACGAAGCGGTAGGACTAGAAGTCGGTCGTTCCTACTAAGGTTCTAGAGCGGTCTCCTACTACGAACTAGCGGTTCTCTCTAGAGCCTACTCTAGTAAGAGAACTCGAGCGGTACTAGCAACGAACTACTAGAATAGGAGCCGCAACACAC
Strand-Sequence-032	ACATCCAACACTCTACGCCCAACAACAACTCGTTACCTAAGAACGCGACCTCGAGTAGCTAGAGAAGTTCGTAGAGATCGTAGTACGTCGGCGCCTCGTACTAGACCGTTCCTAACCTCGTCGGCGAACTCGTCGCCGCTACCGTAGAAGCTCTACGCGTCCTCCTAGAAGCGACTCTCCTCGGAAGTTAGAGCGCTACCTACGAAGCCTAACGACTACCTAAGTTCAACGAATAGGAGCCGCAACACAC
Strand-Sequence-033	ACATCCAACACTCTACGCCCAACAACAACGGACGCGGTAGGAACCTCGGAAGGAGTAGCCTAAGGTAGGAAGGCGAACCTCGCGCCGGTCGGAGTAGCAACAAGTCGAGCGCTAGACTCGTCAAGAGACTAAGCTAGACCGTCTAGTAGTTCGTCTAGAACTAGAACGAACGCGAAGTCTAGGAAGCGACGTCGTCGAGATCGAGGTAGAGTAGGAGACAACTAACTAGTGAATAGGAGCCGCAACACAC
Strand-Sequence-034	ACATCCAACACTCTACGCCCAACAACAACCTCTAAGACGCTAACGCCGTAAGTAGTAAGTTCAACGAACAACCTACGTAACAACGCAACGGACAAGGCGCCAAGTAACTCTAGACTACGTACGGCGTCAAGTAGTCGTCGAGTTAAGAAGAGAGTTAACGGTTCGAAGCCGTTCGAAGACTAAGTTACCTCTAAGGCGGTAGTACCTCGAGGTACTAAGGTAGGAGGACTGAATAGGAGCCGCAACACAC
Strand-Sequence-035	ACATCCAACACTCTACGCCCAACAACAAGTTCGCGAACGGTAACGCGAAGAGAAGTACGTTAAGAGAAGAACGATCGTAACAAGCGTTCAAGTAAGCGACTAGGTCGACCGTTAGCCTAACCGTCTAAGCGTCGTAAGACTAACTCCTAAGGACTCGGAGACTAACGACTAGCGCGAAGACTCTAAGCGGTCTCAAGTAAGGTTACGGCAACGCGTAAGTCTAGTAAGACGAATAGGAGCCGCAACACAC
Strand-Sequence-036	ACATCCAACACTCTACGCCCAACAACTCGTTACCTAAGAACAACGGAAGCGGTAACGGCGGCTCGTAGAGGTAAGGACAAGTCGCTACTCTCTAAGTCTAACCTCCTAACGAAGACGGTAAGAAGAAGAGCGTCGCCGCTACGTACTAGAAGAGAGAGAGACCTAACTAAGGAGAAGCGACCGGAGACGTCGGACGCGTCTAACGCGCGGAAGGCCTCGGTTAGACTACCGAATAGGAGCCGCAACACAC
Strand-Sequence-037	ACATCCAACACTCTACGCCCAACAACGGACGCGGTAGGAACAACGCCGTTCTAAGTAGACTCGAAGGCCTAACGTCGTCGACTAGTACTCGCCTCCTCTACCTCTCGAAGAAGAACCTCTAGAGGTAGACGAACAACTACTAGAAGAGCTAAGACGGTCGGACTCTCGTCTAAGCGAAGAGCGTCCTAACGAACTCGTTACCTACTCAAGCGACTAAGACGAACGGAGAAGAATAGGAGCCGCAACACAC
Strand-Sequence-038	ACATCCAACACTCTACGCCCAACAACCTCTAAGACGCTAACAACAACCTAAGTACCGGAAGAGACGCGACGTTAACTCCTCGCCTCGGTTAGAGGTTAAGGAAGACCGCGAACGAAGCGAACCGGACCTACAAGTAACGAACTCCTAGTCGGAGGTCGGAACGAGACGGTAGAAGCTCGTCGACTCTAAGGTTACGCGCTACGAGCGGACGCTCGAAGAGGTTAGTCGAAGAATAGGAGCCGCAACACAC
Strand-Sequence-039	ACATCCAACACTCTACGCCCAACAAGTTCGCGAACGGTAACAACGAAGTCGGCGAAGAAGCTAGACTAGAACTCTAGAGTACCGAACGAAGTAGCGGCGGCAAGTAAGAGTACGGACAAGCGAGCTACTACGCTCTACGACCTCTCTACGCGAGTCGGAGAGAAGCCGTTCTAGACCTCGTCAACTAGAGCGCTACGAGTTACTAGTAAGCTCGCTACGCTCGGTAGAACGAATAGGAGCCGCAACACAC
Strand-Sequence-040	ACATCCAACACTCTACGCCCAACTCGTTACCTAAGAACAACAACTAACAACGCGGTAGACCTCCTACGAGCGGAAGGTTCTCGACCAAGACGAGTAAGAAGTTAACCGTTCGAGACGGACTAACCGAAGGACGCGCGAGTCGGAAGACCTAACGGTTCTCGTAAGAACTCGCGTAGACCGGCGTCGGTCTCGCCGTTAAGTAACTCGTCAACGGCGGTAGCAACGTCTCGGAATAGGAGCCGCAACACAC
Strand-Sequence-041	ACATCCAACACTCTACGCCCAACGGACGCGGTAGGAACAACAACGGTTACGGACCTACGTTAAGTACTAGCTAGAGGACTAGTAGGTCGAGCTAGTACAAGACCTACGGCCTAGAACAACCTCGACTCGCGTAGAAGACCGCGACCGCCTACGCTCTAACCGCCGTACGACTAGACGGCTCGTTCGTCAACGCTACCAACGTCGCTCTAAGACGTCTCTAGAGCTAAGGAGAATAGGAGCCGCAACACAC
Strand-Sequence-042	ACATCCAACACTCTACGCCCAACCTCTAAGACGCTAACAACAACGCGTTAGAACTAGAAGACAACGGACAACGACCTCTCGCTAACGCCAACGGATCGAAGGAACGAACTAGCCTCGGTTACTAGACCGTCAACGGCGGAGAGACGACCGAAGGCTAACCTCGGAGCGGACTACTACGCCTAAGCGCGAACGTTAACGGACGTAGCCTAACGGAAGCGAGCGCTAGAGACGAATAGGAGCCGCAACACAC
Strand-Sequence-043	ACATCCAACACTCTACGCCCAAGTTCGCGAACGGTAACAACAACTAACTCTAGAGTTAGACGAGGACGTTAACTAGGAGGACCTACCTACTCGCTACCGCTCGGTCGTTACTCGCCGGCGTCGCGAGTAGCAACCTCTACAAGAGGTTCAACTAGGAAGCTCGCGAACAACCTAGGACTAAGTCGTAGTCGTACGGACCTCGGAGGAGTTCGTAGTAACGCGGAACTAGGGAATAGGAGCCGCAACACAC
Strand-Sequence-044	ACATCCAACACTCTACGCCCTCGTTACCTAAGAACAACAACAACGAAGGCGGCCTCCTAACTAGCGGCGGCGGTTCGAACGGTTCGACGAAGAACGTCGGCAACGGCGTCGAAGTCCTCGGAAGTAACAACCTACTCCTAAGAGAAGAAGGCGCGTTCGGCGCTACTACGAGAGAGTCGAGCGGTTACGAACAAGCGACTACGAAGTAGGAAGGAAGATCGTACGCTCTAGAATAGGAGCCGCAACACAC
Strand-Sequence-045	ACATCCAACACTCTACGCCCAGACGCGGTAGGAACAACAACAACAACTACTCGAGACGCCTCTCGTACTAAGGAACGTTCGCCGAAGCCAACTACGGACGCGGCCTCGGAGAGAGCTCGAGTAGACAAGCGTAGTTCGCCGCGAACCTCGGAAGCTAGAGAGAAGAGACGGAAGCTCCTAGCAAGAGACTAAGGAGTCTCTAAGGCGTCAAGTCTAGCTAAGGCGAAGGAGAATAGGAGCCGCAACACAC
Strand-Sequence-046	ACATCCAACACTCTACGCCCTTCTAAGACGCTAACAACAACAACGGTTAGAGACGCTCGACCGGAACCTCGTCGAGAACTCGCGCGACCGCTACCGTTACGAGGAGGAACAAGACGAACGCGTAAGACTCGAGCTCGTAGACGAGATCGAACGAAGGTAGTTAGAGTCTACGCTCGAGAACGACGTAAGTCCTAACTAAGTTACTAAGGAGTAGCAACGGCGCCGAACCTGAATAGGAGCCGCAACACAC
Strand-Sequence-047	ACATCCAACACTCTACGCCCTTCGCGAACGGTAACAACTACGCCAAGTCGTACTACAACGCGACGACTACTAAGTCGTCGTAGACCAACGGTAGCCTCGGCAAGAGAACGACGTCGAACTACGTCGCTAAGACTCGCGAAGCTCCTCGAACGTTCGGAACTAGCGAAGGAACGAACGGTAGAAGAAGCAAGTAAGGTAAGAAGTCGACTCGCGCGTTCGAACAAGTCGGCGAATAGGAGCCGCAACACAC
Strand-Sequence-048	ACATCCAACACTCTACGCCCTTACCTAAGAACAACAAGACTCTCTAGACGACGTAGTTCAAGAAGTAGGAACCTACCGTAAGATCGTTAAGCTACAAGTTACGCTAAGACTAAGCCTAACTAAGGTAAGCCAAGAGTAGACCTAGAAGTCTCTACAAGGAACCTCGCGAAGGCTAAGCCGGTCGGAACAAGAGCGCGAACGGCAAGAGAGAAGCGACTCGCAACGCCTACGAATAGGAGCCGCAACACAC
Strand-Sequence-049	ACATCCAACACTCTACGCCCTAGAGTAGGAACAACGTCGCCTAAGTCGCTCTCGGATCGTACAAGAGTTAAGGTTAACGCCTCCTAACCGTTAACGCGTTCGGAAGTACTCGGTAGAGTCTCTAGTCGACTACGACCGCTCCTACGGAAGGCCTAAGCTAAGCTAGCGCGACGACGAGTAGGAGTAGCGGTAGACCTCGCTCGAACAAGGAAGAAGTCGAACTACCTAACGAATAGGAGCCGCAACACAC
Strand-Sequence-050	ACATCCAACACTCTACGCCCTAAGACGCTAACAACGCTAGATCGAGTCTCAAGTAGTACCTCGTCGCTAGAAGTACTACCGTCGCTCTCGCGTAGTAAGACTAAGGAGAGTCGTCGAACTACGCGTCGTAGTAAGGCGTCTCGTTACTCGGAGACTCGAAGTTCGCTACCGGACCTAAGACTCTCTCGTACGAAGGTTAAGCGACCGCCGAACGCTAGACCTAGACCAACGAATAGGAGCCGCAACACAC
Strand-Sequence-051	ACATCCAACACTCTACGCCCACGAACGGTAACAACGGTAGGTCGACTACGACGTTAAGACAAGACGTCTAGTCGAGAGAAGACGGACGCAACGGTACCTCGTCGTAAGTCTACTCGTTCTACAAGAAGACTCGCCTAAGATCGAGCGCTAGCGCGTCGAACTAAGGAGAAGCTACTACCTAACTCTACTCGACTCTAAGGAACGCTCAAGAAGAGACCGGCGCGAACCTAGAATAGGAGCCGCAACACAC
Strand-Sequence-052	ACATCCAACACTCTACGCCCTACAAGAACAACAAGAACGCTACGAAGAGTAACGGAGAAGGATCGTAAGCCAAGAGCCTCTAAGGTAGACAAGGAACCGGCCTCGAACGCTCGAGTAGGTTAAGTAGAGACGCGTACAACAAGAGGACCAAGACGTCGGAACGACTCGCGTAACGAACGAGTTACTAGGAAGTCGGTCTAGACGTCTAAGCTCGAGAGACTACGAGTAGAGAATAGGAGCCGCAACACAC
Strand-Sequence-053	ACATCCAACACTCTACGCCCAGTAGGAACAACGTCAACGCTAGCTACGGTTAGTTCGAAGGCGCTCTAGAGAAGAGAGAGAGCGTCGGACTCGGACAACAACGCGCTACGAACTACGGCGCCGTAGAAGCGACCGTCGCGAACAACGGTCTAGAGAACGCTAGTAACTAAGACGGTACCGCCGTCGAACTAACTAACCTACAAGCTCCTCAACGAGACAAGTTCGTCGCGGAATAGGAGCCGCAACACAC
Strand-Sequence-054	ACATCCAACACTCTACGCCCAACGCTAACAACTCCAACGCCGGAAGAACGACTAGGCGGACTCAAGGAAGACTACTCGCCTAGTTCGCTAACTAGAACGAAGCTAGCGTCTAGAGCAAGAGAAGATCGTTCGCCGGCTCGTAAGCCGGCGCTACGAAGTACGAAGGTAAGAACGGAGAGTAACAAGCCAAGGCTACTACCGGTACGAACAACGCCGTTAAGAGTAGGTTAGAATAGGAGCCGCAACACAC
Strand-Sequence-055	ACATCCAACACTCTACGCCCAACGGTAACGACGGTAACGAACTACCTAGTAGAGACTAGACGAACGCTAGGAGGTAGTACAAGAGTCGGTACTAGAGTACGTCGTAGACTAGAAGCGCGTTCTAGACGTCGTTAGAGTCGTACGGCGCCGTCAAGACTAGGCGGTCGTCGAGCGCGACCGTTACTCTCGGTAGACAAGCTCCTAGCGTCCTCGGACGCGGAACTACTAGCGAATAGGAGCCGCAACACAC
Strand-Sequence-056	ACATCCAACACTCTACGCCCAAGAACAACAAGAACAAGACCTACGCTAGAGAAGACGGACTCGCTAGAGACGCGTTAACGACCTACAACGCGTAGAGCTACTCGAGAGAAGCCGCCGGTTAGAGGTCGAGGTCGAGGTCGAACTAAGGAGACCTCTCGACTCGCAAGTACTAGAAGGAAGTCGCGACTACGAAGACTCGACAAGGTCTAAGACCTACCGTAAGATCGTCGGAATAGGAGCCGCAACACAC
Strand-Sequence-057	ACATCCAACACTCTACGCCCAGGAACAACGTCAACGTCTAAGGTAGTTAAGGAACCTAGACCGTTCGCTACGCTCAACGCGTCGCTCGAGAAGAGAGCTAAGAAGCCTCGAGAACGGAACGCTAAGCCGGTACCGTAGAAGCGAGACTACTAACCGTCTACCTAAGTCTCAAGTAGAAGAGTAGGAGGTCGAGAAGGAGGACTCTCAACCTAAGGAACGCGAGTAGAAGCGAATAGGAGCCGCAACACAC
Strand-Sequence-058	ACATCCAACACTCTACGCCCAGTAACAACGGTAACGAACTAGACGGTACCTCGTACGGACCTCTAACTAGAGACGGAGAGAGCTCGTCGTTACCTCGCTAACTCGCTAGAAGAAGAGACGTCGCTAACTAACAAGCTCGCGGCGTCGGTCGGACCAAGACTACTAGGTACGCTAGACAAGCCGCGAAGTTAGAACGAAGAAGTCTAAGGTAGAAGACCGTAAGCTCGAGCGAATAGGAGCCGCAACACAC
Strand-Sequence-059	ACATCCAACACTCTACGCCCAACAACAAGAACAAGACCAACGCCGTCGGTTAAGCTCGCAACTACGTCGAACAACCTAGGAACGCTCAACGCGGTACGTAGACTCTAAGCGGTTAGAGGACCTAGAGGTACCTACGCGTCGTCTACGGAAGCGCCGTCGCGAGTAGACTAACGAACGGCTACAAGTTACGACGCAACAAGTAACTAACCGTTCAACGAGACAACAAGTTCGAATAGGAGCCGCAACACAC
Strand-Sequence-060	ACATCCAACACTCTACGCCCAACAACGTCAACGTCGAAGACGAACTAAGCCTCTACGGACCTCGGCGGAGCTAAGGCTAACGCCTCGCGACTAACTAACGTTCGAGCGCCGGCGAACGCGGCAAGTTAAGCGCGTTCGAAGGAACTAGAAGTAGAAGAGAACTAGAGAGATCGTTCAAGAGGTTAACCGCGAGTAACGTCGGACAAGGACTACTAACGACTACGACTAAGGAATAGGAGCCGCAACACAC
Strand-Sequence-061	ACATCCAACACTCTACGCCCAACAACGGTAACGAAGGTAGGAGTAGTCTCGGAAGCGCCGGACCTCTACGAAGAAGCGGCGAACCTCTACTCTAACGACGCTCGAAGGAAGCTACGTAGTAGAACCTCTAGTAGTTACTAACGTTCGAACGAAGCTAGTCGTACCTACAAGAGACTAGCCTAACTAACGGACCTCGCTAAGGCGCCGCGGAAGCCAAGACGTTCGGAACCGAATAGGAGCCGCAACACAC
Strand-Sequence-062	ACATCCAACACTCTACGCCCAACAAGAACAAGACCAACGCCAACAACGGCTACGGAACGACGAGGTCGTCGACGCGGTCGTCGTAAGGCGCTAGACTAAGCTAAGGTAAGTACTAGAGAGAACTCGCGTACGCTAGGTCGAGTTACTCGACGAAGTAGTACTAGACCAAGAACTAGTAACGAACCTAACTCGCGACTAAGAGGTAACTCGAAGCCTACTACGCGACCAAGGAATAGGAGCCGCAACACAC
Strand-Sequence-063	ACATCCAACACTCTACGCCCAACGTCAACGTCGAAGACGAAGACGGCCTAACTAGTACTCTAGAGGAACAACTACGAAGCGAAGTCCTCTACGCGACTCGACGCGTCTACTAGAAGAGTAGTTACGAAGCCGTTCGGAAGACTAGTTCCGAACAACTCGAAGTCTAGACCGTAAGAACTCAAGAACGCCTACCTACCGGTCTAACTAAGTAAGGTTCGACGAGATCGACGGAATAGGAGCCGCAACACAC
Strand-Sequence-064	ACATCCAACACTCTACGCCCAACGCTAACGCCGCTAAGACTAACAAGTAACGCGAACAAGCGTTAAGGAGGAACTAAGCTCTCCTCCTCGGCTAGTCGACCGCCTAAGGTACCGGTAGCGCGTAAGAAGGCTCGAGCAACGCTAAGTAGAGTAACTCGAGCGACGCGTCGAGGTACGGCCTACTCTACGGACAAGTCTAGTACCTCAACAAGAGGACTCAAGGAACGAGGGAATAGGAGCCGCAACACAC
Strand-Sequence-065	ACATCCAACACTCTACGCCCAACGGTAACGAAGGTAGGAGTAACGGTCTACTACTCAAGTCGACCGGTCGGTTAACGTAGTAAGTCGCCTAGTCGAACTACTAGAGAACTCGATCGAGGTACAACGCTCAAGCTAGCTACTACAACCTAGAGTCGACTAGAAGCGGTACCGGCCTAAGCGAAGGTAGTAGGCGGAGGAGTAAGTTCAACAACGTCGCTACGACCGGTACCGAATAGGAGCCGCAACACAC
Strand-Sequence-066	ACATCCAACACTCTACGCCCAAGAACAAGACCAACGCCAACAACGCGAAGACTAAGTACGTCGCGACTCCTCGCAACTAGAAGTTCGAACGACGCAACTCGAGGAGGAGGACGTAGTTAACTCCTACTCTAACTCTAGAAGACGGTAGGAAGTACTAGACGAGCTCGACCTACAAGTACGCCAACGGCGTCGAACGCGGTACCGTTCTCGCCGAAGAAGCTAAGAGACTAGAATAGGAGCCGCAACACAC
Strand-Sequence-067	ACATCCAACACTCTACGCCCAGGAACGTCGAAGACGAAGACAACGGAGACGGAACTCGCTAACTACGAACCGGTTAACTAACTCTACTCCTCGAACGCAAGAGAAGTAGGTTAAGGCGGAGGACGGAAGCGACTCGGACTCGAACGAACGCTCTACGCGAACCTCGAGACGGTTAGAGGCGGCGGAGCGCCGGTTAAGCGGTAAGAGAGTAAGACGGTTCGAAGTACGTAGAATAGGAGCCGCAACACAC
Strand-Sequence-068	ACATCCAACACTCTACGCCCACTAACGCCGCTAAGACTAACAACGGTACTCGAACCGGTAACAAGAGGTACTAACGCCTAACTCCTACTAGTAGAACCGTTCCTCGGTTAGAAGGCCTAAGAACTAACGCGTAACGAACGGAAGACAAGACCAACAACCTCGTCGAAGAACTAGAGTTACGAAGCAACGGCGGCGGTCGGAGCGGACTCGCTAGGAGTCTACGCGGCTACGAATAGGAGCCGCAACACAC
Strand-Sequence-069	ACATCCAACACTCTACGCCCAGTAACGAAGGTAGGAGTAACAACTACGGAACCGGAGAGTACGAAGCCGAAGCCGTCTCGAAGAGTAACGGCGCTCGGAGAAGTAGGAGAAGTTAACCTCCTCTCAAGAGCTAGAGGAAGACCAACTAGAGCTACGAAGCGTAGGAACGCGGAAGAAGAAGGAGGTAAGCTCTCGCGAGTACCAAGTCGTACTAAGCTAAGTAACTAAGCGAATAGGAGCCGCAACACAC
Strand-Sequence-070	ACATCCAACACTCTACGCCCAACAAGACCAACGCCAACTACGCCGCTACTACGAACCTCTACCTACGAACGGAAGAGACTCGAACTAGTCTCCTAGACGAAGCTCCTCGGACTCGACGCTAGAGCGCCGGAAGGTTCGGAAGCGTCCTACTCTAGTAACCTAACAACCTCCTAACTAAGTTCGCGACTACGAGGTTACAAGAAGTCAAGTACGCGACGACCGTTCCTCGAGAATAGGAGCCGCAACACAC
Strand-Sequence-071	ACATCCAACACTCTACGCCCAACGTCGAAGACGAAGAGAGTCGGAGACCTAGAAGTTAGACCGCTACTCTAGAGAGGTCGACTAGGAGAGACCTCTACCTAGAGTAGAGCCTAAGCGCTCTCCTAAGAAGCTACGGAGAGAGGACTACTCGCGGATCGAGATCGTCGACCTACGCGAGTAGTAGGAACAAGTTCCTCTAACCTCGGAGTTAGTTACCTAAGTAACTAAGGGAATAGGAGCCGCAACACAC
Strand-Sequence-072	ACATCCAACACTCTACGCCCAACGCCGCTAAGACTCGAGAGACTAAGAGTAAGTAAGTCGCCGCTCGACCTCGACAAGTCAACAAGTACTAGAACTAACCTACGAGTAACGAAGGTAAGAAGTACGGAAGCCTAGACGGTAACAAGTAAGCCGGACGCGCCTAGAACGGACGGAGTAAGTTAAGGAGCCTACCTACCGGAAGTCTCGCTCTCGCGTAGTTCGAAGGTCTAGAATAGGAGCCGCAACACAC
Strand-Sequence-073	ACATCCAACACTCTACGCCCAACGAAGGTAGGAGTACGAGGAGTCTAGAAGCTAGCAACTAACGCAACAACGAACAAGCGAACGGACTAAGAACCAACTAGACCGGCTCGAACGCGGAAGCGGAACGATCGAACTAGAGAAGCCGCGGCGTCGCGAAGGAACGACGACCTCGCTAAGGACTCTAACTCGCCTACTCGTCGAGGACTAGGTAGTAGAACAACTAGGAAGAGGAATAGGAGCCGCAACACAC
Strand-Sequence-074	ACATCCAACACTCTACGCCCAAGACCAACGCCAACTACGCCAACCTACGCCTCGCTAGCGCTAAGTAAGGCGCGTTCGCCGTTACCGTCGCGTTCGGTTCGTTAAGACTCGGCCTAAGAAGAAGCGGTTAGAGAGACGAAGCTAGACTACGCCTACTCGTCTAGTAGTAGACCGCCAAGTAGTTAGAAGGCTACTAACCTAACAACGGCGCCGCTCTACGAACCTAAGCGGAATAGGAGCCGCAACACAC
Strand-Sequence-075	ACATCCAACACTCTACGCCCAGGCGGAACGAAGAGAGTCGGAACGCTAACGAACAACGAACCGGACTAAGAACGAGCAAGAGCGGCGGTAAGTCGTAAGAACTACTAACCTAACAACCTAGGCGGTAGGAACGCCTACTAACGTCGTTACGAAGGACCGGAGAACAAGAAGGCTCGTACTCGTCGACCAAGTTCGGTTAACTCTACTAGAGTAGGACGTACTACGGAGAAGAATAGGAGCCGCAACACAC
Strand-Sequence-076	ACATCCAACACTCTACGCCCACCGCTAAGACTCGAGAGACTAACGAAGGAGAAGCCGTCGGCTACGGCTAGACTAAGTAACCTCGAGAGAGTAACTCGAGTCGGAGAAGGAGGTAAGCTCTCGCCTACGGTTCGTCGGAACGCAACTCGACTACGTTCGGCTCGTACTCGAACCTACTCTAGACTAGCGGACCTAACGGTTACAAGAGCTCGAAGTAGACGTTAAGTAGCGAATAGGAGCCGCAACACAC
Strand-Sequence-077	ACATCCAACACTCTACGCCCGAAGGTAGGAGTACGAGGAGTAACAACGGTAGTTAAGACAACGCCGAAGAACAAGCTACGAAGAAGGAAGCGAGTCTAGACTAGACCTAGACCGTAACCAAGACGACTACTAGCGCTAGACAAGAGGAACGAAGACCTCAAGAGAGTCTAGAACTCTAGGAAGGAACCGGTAGAACGACCGTAACGTAGTCGACTAGACGAGGACAACGCGAATAGGAGCCGCAACACAC
Strand-Sequence-078	ACATCCAACACTCTACGCCCACCAACGCCAACTACGCCTACGCCGCGACTAACGGAAGCGGACTCTCGAGCTACGTCCTACTACTCGCTACCAACTAAGGCTAAGGACCTAGCGGCGCTAGGAGGTAGTAGTAGTTACGCGGTTAGTACGGTAAGAAGAACTAACCTAACCAACCTAGTTCGAACTAGTAGTAAGACTAGTAGAGTAGCTACGCTAGGAGCGGCTAGAAGGAATAGGAGCCGCAACACAC
Strand-Sequence-079	ACATCCAACACTCTACGCCCGAAGACGAAGAGAGTTAAGGTCGGACTAAGGAACGCAAGTAGTAACGCGGTTACTCGAGCAAGACTACGTCGAGTAAGTAGGAACGTCAACGCGGTAAGTTCCTCTACGCCAAGTAAGCTCGAGACCTCTACGGAAGGTAAGAAGGTAGCGAACAAGCCTAAGCGAGCTACGGCGAAGACTACTCGTACTAGGAACGAGACTAGAGTTAGGAATAGGAGCCGCAACACAC
Strand-Sequence-080	ACATCCAACACTCTACGCCCACTAAGACTCGAGAGAGACGCAAGAAGGAAGAACAAGAAGAACTAACCGAAGGAAGGAGCCTCGGAAGCGGTAGTAGAGAGAACCTCGGACAAGAGACGTTCTACAAGAGCTACTACTAGAGGTTCGCGTAACAAGCCGTACTCAACGCGTTAAGTCGGACTCTAGAAGCCGAACGCGTCGGAACCGGACGCGGATCGACCGTCCTCGAAGAATAGGAGCCGCAACACAC
Strand-Sequence-081	ACATCCAACACTCTACGCCCAGTAGGAGTACGAGGTTCGAAGTCCTAAGCGTCAAGACTACCTACGGACTCGCCAAGACGTAGTCGAGAGAGAGACCTCAAGCTAGGTTAACTAACGCGTTACGCCTAGACCTACGACAACGAACTCAAGCTCGGAGCAAGAGAAGGTTAGACGGCAACAACGCGAGAAGCGTCGCGTTAACGAAGTTCTAACAAGGAACCGCCGCCTAAGAATAGGAGCCGCAACACAC
Strand-Sequence-082	ACATCCAACACTCTACGCCCAACGAAGAGAGTTAACTCAACGTCGGTAGTAGGTTACTCAAGAGAACCAACCTAAGGTCGACGTAACGAGAGTTCGGATCGTAGAGTTAGACGACCGTAACGACTCGACGCGGTACCTACTCGACTCTACCTAACGCCGAAGACGAACTAACGACGTAAGAAGCGAGAGACGCCGTAAGTCGGAACGAACGCGGTAGGAGGACGTAGACCGAATAGGAGCCGCAACACAC
Strand-Sequence-083	ACATCCAACACTCTACGCCCAAGACTCGAGAGAGACTAGACGCTACCGTTCGCGCGAGTAGAGAACCTACTCAAGCTAGCCTAACGAGGTCGTAGAGGTTAGAAGGAGAGGAACAAGCGAGCTCGTCGAGACTACGAAGGTAGAGACCTAGTCGGAAGACTAGAGACTCGAAGAGACTACAAGGTTCGACGGAAGCGAGGCGGTTAACGACCGGTAGCGCCAAGACCAAGGAATAGGAGCCGCAACACAC
Strand-Sequence-084	ACATCCAACACTCTACGCCCACCAACTACGCCGTAAGTAAGAACGTCCTCTAAGTCGGACCTAGCTAAGAGAAGTACTACGGAACTACTCTAAGTAAGTTAACCGAAGGATCGAGGTACGCTCAACCTACTACGACTACCGGATCGAACTAGTAGACGTACGGAGAACGCTAAGGACTAACCGTTAGAGAGACCGTCGGTAGCGCGAAGTTACTCGCTCTCAACGAACCTGAATAGGAGCCGCAACACAC
Strand-Sequence-085	ACATCCAACACTCTACGCCCGAAGAGAGTTAACTCAACGTCAACAAGAGGAGCGGCAACGTCTCGTAAGGAACCTAGACTCAAGCGAGGAAGTACTAGTTAAGTCGGACGACTACGAACGTCCTAACGAAGACGAACTCTCTCCTACTCGGACTAACCTACGGAAGTAGGAAGAGAAGTCTCCTAAGGACTAGAAGGTTAAGGTTCGGAAGAGAGACGTAGACTACGTAAGAATAGGAGCCGCAACACAC
Strand-Sequence-086	ACATCCAACACTCTACGCCCACTCGAGAGAGACTAGACGGTACCGCCGTAGAGACGAACTCGAGGAGGAGTAGCGGACTCGAACTAGAAGAAGTCTAAGAGTTCGTCTAGACTACGTCGAGCGTCCTCTAGACCGCCGGCGGAGACAAGACGAGGTTCCTCTAGTCGTACGAACTCGCGAGCGTCAACCTCTCGAGTTAAGACAAGAGAGACAACTACCTCAACCTCGCCGAATAGGAGCCGCAACACAC
Strand-Sequence-087	ACATCCAACACTCTACGCCCAGTACGAGGTTCTACAAGAACGAACAACGCTACGGTCGGTCGAGTTACTACAAGTAGAGTTAGTACGGAGAGTTCGGACAACTAACTCCTCGAAGCGGAAGCGCTAGTTCGTTCTACGAGAGTTAACGCTCGTAGACGACCGAAGGTCTCGCCAAGTTCTACCTCGGTTACAACGGAACGTTAGACCTACGCAAGTCGAAGTAGTACGCTGAATAGGAGCCGCAACACAC
Strand-Sequence-088	ACATCCAACACTCTACGCCCAACTACGCCGTAAGTAGGTAGAAGTACGCCAACTACCGTTAGAGACAAGGCAAGACTCTACTCCTAACCGTTAACGGTCGGTTAAGCGCCGGAGAGGAACAACTAACCTACTACGCTCGAACGAGAACGTTCGCTAGCCTCGGCGGCTCGAGCGGTTAAGACGCTAGAGACTACGCCTAGGAAGGCGAACGAAGCGCTACCGGTTACAACGAATAGGAGCCGCAACACAC
Strand-Sequence-089	ACATCCAACACTCTACGCCCAAGAGTTAACTCAACGCCGAAGTCCTCTACAAGAGGAGGACCGGAAGTCTCGCCGGACAAGTCCTCGGTAGCGCGAAGAGCGCCGCTCTACTACGCGCTACTAGATCGAGGTAGAGGAACGCCGGCGGTCGGAGTACCTACAACCTACTCTAAGCTAGCTAAGTAAGCTCGAGCTAGAACTACGAAGTAAGACGCGGAGACTCTCGTAGTGAATAGGAGCCGCAACACAC
Strand-Sequence-090	ACATCCAACACTCTACGCCCTCGAAGAGACTAGACTAAGCTACTACTAAGTAGAGCCTAGACGAAGGTACCGTACGCCTCGAAGCCTAAGTCTAGTTCGGCTACTAACAACGAAGAAGAACCGTACTACGACAACGCGGACTCGAAGGCTCGTCGACTACGAGAGAACTCTAAGCCAACGGAGACTACGAAGCTAGTACTAACAAGGAAGTCGTCTACGGACCTAAGAGAGAATAGGAGCCGCAACACAC
Strand-Sequence-091	ACATCCAACACTCTACGCCCACGAGGTTCTACAAGACGAGTAGTTAGAGAGAGAGAAGGAGCGGCAAGAGAAGGCGGAGTTAAGAACGAGAGTAAGCTAGTAAGTTACGCCTCGCCGTCGGCCTCTCGTCGTAGAGGTTCTCGTAGTAGAGTACCTCGAAGAAGAGCGCCGCCGCCGGTAGAAGGCCGAGTAGATCGGAAGGTAGGAGACTCCTAACTAAGAGACAAGCGGAATAGGAGCCGCAACACAC
Strand-Sequence-092	ACATCCAACACTCTACGCCCTACGCCGTAAGTAGGTAGAAGAACGCTCGAACGACGTCGTAGTACTAAGAGTAACGCTACAACGCGTACGCCGCTCGCGCGTACCGTTACGCCTACTACAAGAACAACGAACCTAGTACTCAAGGAGACGGTAAGGAACGCGCTAGAACGTTAGACAACGCGGAAGCTCGGACCTAGAGGTTCGCGTCGAACTAGACGTCGTTCAACGTCGAATAGGAGCCGCAACACAC
Strand-Sequence-093	ACATCCAACACTCTACGCCCAGTTAACTCAACGCCGAACTAACCGAACGAGACGCCAACCTACGCGCGACCGCTACCGCGAAGACTCGAACCGGTACTAGAGACTAAGGAAGTACTAAGCGGAGAGAGACGAGGAACTCGTTCCTCAACGGAAGCAAGGAACGCTACGGCTACCTCAACAAGACTCTAACCGCGTCGTACGGAACCTACCTCCGTCTAAGCGCGTACAAGGAATAGGAGCCGCAACACAC
Strand-Sequence-094	ACATCCAACACTCTACGCCCAGGTTCTACAAGACGGAAGAGTTAAGGACGAGCGTCTAGTTAACGAGTTCGTAAGGCGGTAAGTCGACGTTACCTCTACCTAGCTAGTAAGACTCGTTAACCAACGGCTCGACGTCGACGACTAACGCTCGGTCGACCAAGAAGGAACAAGGTAACTACGCGGAACGCGAACGCTAGAAGAGACGCCTAGACGTCCTCGTCTCGTTCGCGGAATAGGAGCCGCAACACAC
Strand-Sequence-095	ACATCCAACACTCTACGCCCACCGTAAGTAGGTAGACTCGACCTCGGTTCGTCCTCGTCGCTAGAAGAAGTAGTTACTACAAGAGACGCGCTACGTACGCTCGCGCCGCGAGAACGTTCAACCTCCTCGGCAACTACCTCAACTAGTAACTACCTAGCGCGACTAGTAGCGCCGCGACGACCGCGGAACTACAAGACGGAAGTAGGTCGTTAAGGTACAACGCGAGTACTGAATAGGAGCCGCAACACAC
Strand-Sequence-096	ACATCCAACACTCTACGCCCTAACTCAACGCCGAAGGTAGAAGTACGACCAACTAGGAAGCCAACTCGTACGAAGTCAACAACGGCGGAACTCGACAACTAACGAGTCGGAGCTAGTCGAGCAAGTTACGCTACGCGAGAGAGAAGAGTAGCTAGACCGCTACTAGTACTAGGTAAGCCGTACGAGGTTCGAGTTAAGCCGTCTCGAAGGAAGCTAAGTAGGAAGGTTAAGAATAGGAGCCGCAACACAC
Strand-Sequence-097	ACATCCAACACTCTACGCCCAGACTAGACTAAGCCAACTCGACCGAACTCGAACGAAGGCGGTAACGCCTACAAGAAGGTAGGACTCTAAGCGTCCTCGGCGTCAAGAGCAACCTCGTCGTCGGTACGAGCAAGTACGCGACTAGGAGCGGCTCGTACAAGTTACTACTAAGAACTAACGGAAGACGCGCCTCGTAACGAAGACGCGAAGAGACTACCGCGTTAACCTCGGAATAGGAGCCGCAACACAC
Strand-Sequence-098	ACATCCAACACTCTACGCCCTTCTACAAGACGGAAGACGCGGAAGCTCCTCTCGAAGGCGTCCTCCTCAAGTTCTAGACCGTCGGTAGAAGCAACGCTAAGACCGCGTAAGCGTCGAAGAGAACGACGACTCTACTAAGGTTACAACTCCTCGGCGCGAAGTACAACTACTAAGACTAGTTCGTCGCTCCTAGGAGGAGCGGACGCTCGACCTCCGAAGAAGAGTCGACCGAATAGGAGCCGCAACACAC
Strand-Sequence-099	ACATCCAACACTCTACGCCCTTCGGTAGGTAGACTAACAAGAAGACGAAGACCGTAACCAAGAGCTAACGAGAACCTCGAAGCTAAGGCCTCAAGTACCTCGAACTACTAAGGAGGAAGACGTAGAGAAGGAGCCTACCTCGGTAGTACGCGAACCTCGTCGCGTAGAAGTCGAACTAGTCGAGAACCTAGAAGTTCGGCTAAGCCGTTCAACGCGCCGCGTCGACGACGGAATAGGAGCCGCAACACAC
Strand-Sequence-100	ACATCCAACACTCTACGCCCTTCAACGCCGAAGGTAACCTAAGATCGAGGACGACGAGAAGTAGGTTACGAGAACAACGCTCGTTACAACGAACTAGGCGGTAGTAAGCCAAGAGGCGGCGCGCGAGGTACAACTAGTACCTAACGACCGCTCTAAGCGCTCGGAGGCGGCGGTTCTCGTAGGAAGACGCTAGGAACTCGAGGTTCGCTACGGAACAACAACTAACGGAAGAATAGGAGCCGCAACACAC
Strand-Sequence-101	ACATCCAACACTCTACGCCCTTAGACTAAGCCAACAAGAACTAACTCGGCTAGAGCGCGGAAGAGAGTAACTCGGAAGGTAGGTACAACGCCGCCGGCCTACGCTAAGCGACTACTAGGACCTCGACCGCCGCCTCGAACCTCGCGAGCAACTAGTACGGCCTCTACTACTACTAAGCCGGCGTAAGCTCGAGTACTAAGAGCTCGCGTAGCTAAGGCTAGTCGTTAAGAGAATAGGAGCCGCAACACAC
Strand-Sequence-102	ACATCCAACACTCTACGCCCTACAAGACGGAAGACGTCTAGTCGAACCTACAAGACCTAAGGAGCTACTAACTAACGGAAGGTACCTAACGAACTAGGAGGAGCGAACTCGCTAACGTCAACCTCTAGAACGCGTACAACGAAGGCTAACAACAACGCCTCTAAGACGGACTACGACAACCTACTAAGAGTTACAAGACTCGCCTAAGCGTCAACGAACGAAGGACGACGGAATAGGAGCCGCAACACAC
Strand-Sequence-103	ACATCCAACACTCTACGCCCAGTAGGTAGACTAACGCCGCGTCGTTCAAGACTCGACTCTAACTAGAACCTAGAACCTACGTCCTCCTACCTAACGGTAGTAGAGAGTCGTAGGCTAACGGCAACGGACGCTCGAGGAAGAGGTACCTCGCGTCGAGTAGAAGACTAGACTAGTCGTTCCTACTAACTAGCGTCGGTACGTTACGCAACGCGAGACCTAGGACGACGACGGAATAGGAGCCGCAACACAC
Strand-Sequence-104	ACATCCAACACTCTACGCCCAACGCCGAAGGTAACGAAGACTCGAGAACCGTCGCCGTAAGGAGTTCGAGAGACGCTCTACGAAGTCTAACCGGCTCGAAGAGTTAAGACTACGGCCTACCTACCGGCGTCAACCTAGAACGAACGAACGCTCGCGGCTAACTAGAAGAAGAGAAGACGACCGCCGCTAGACTAAGAAGTCTCTACGCCGTAACGAGGAGACAAGGTAGTGAATAGGAGCCGCAACACAC
Strand-Sequence-105	ACATCCAACACTCTACGCCCAACTAAGCCAACAAGACTAACGCGTAAGGTACCTACGTCTACTAGGAAGCGAGATCGTCGACGAAGAGCAACAAGTAACTAAGAACTCCTAGGTAACTCAACTACGAAGCCGTCCTCGTCTAGAGGACCGTCGAAGGAAGGAGAACTAGTAGTAAGTCGTTACGATCGGAAGGAGAGACCTAGACCGTAACGTACTCGTTCTCGAGCGAAGAATAGGAGCCGCAACACAC
Strand-Sequence-106	ACATCCAACACTCTACGCCCAAGACGGAAGACGTCGGTAACTACAAGTACTCGACGAGAAGAGACCTCGGTTAACTAAGTACCGTCGGTCTCCTACGAACCAACTACGTCGAAGACTAAGAGAACTAAGACGCTCCTACGTAGACCGCCTAGTTCGAACTAAGGTAGACCGTTAACTAGAGTAAGTTCTACGCCTAGACTCCTAGCGGTTCGGAACGACAACGACTCCTAGAATAGGAGCCGCAACACAC
Strand-Sequence-107	ACATCCAACACTCTACGCCCAGGTAGACTAACGCCAACAAGAGTAGGTAAGCGTAACAACTCTAACTCTCGGAACAACTAGACTAAGGCGGTACTCGGAGCGTCAACGCTACGACGTTACGAAGTTAGAACGCGTTAAGACTACAAGCCAACGAAGACAAGTTCAAGACCGAAGCCTAAGGAACCGCGTCGAGACCTCAAGGTTCGAGTAACTAAGCCTAAGCGTTACTAGAATAGGAGCCGCAACACAC
Strand-Sequence-108	ACATCCAACACTCTACGCCCACCGAAGGTAACGAAGACTCGAACTAAGCTACTACTCTCTACTACGGTTCGAGAACTCGCGGTCTACAAGAGAGGTTCAACTACTAAGGCTAAGCGAGGACGAGACCTCGCGCGAGACTAGAACTACGAAGGTTCCTCGTCGCCGAAGCCGCCTAGACTCGGTTACTCTACGGACTACAACGAAGAGTACGAAGCGTCCTCCTCGGTTAAGAATAGGAGCCGCAACACAC
Strand-Sequence-109	ACATCCAACACTCTACGCCCTAAGCCAACAAGACTAACGCGAACCTAACGACGAGTCTAGACTACCTAAGGAACGCCAAGAGAAGGACCTCGACCGTTACGAAGAACTAACTCGAAGACTAAGAAGCCGGCTCGTTCGGAACTAGTACTACCGTAGAAGAGAGAAGTTACTAGACGACCGTAACTCTAAGAACTACTCCTACTAGACTAGGAGAAGCCAACGTCCTCGCTGAATAGGAGCCGCAACACAC
Strand-Sequence-110	ACATCCAACACTCTACGCCCACGGAAGACGTCGGTAACAACGCCTACTCGAGCTAGACTAACGGCAAGACGAGGTAGAGATCGTAAGAGTAGACCAAGACTACCTAACAACAAGCTACGTACGGTCTACGAAGGACCGGAAGAACGTCGTCGACTAACTAACTAACGAACGTCAACGCGAGAACTCAAGGCGGACAACTCGGCGAAGAGGAAGACTCGTTAACTCTCGCCGAATAGGAGCCGCAACACAC
Strand-Sequence-111	ACATCCAACACTCTACGCCCTAGACTAACGCCAACAACAACGAACTCGGAGAAGCGAGCGCCAACGCGTAGACGAACTAGACCGTTAAGACCTCGAGCGGTAGCGGCGCTAGTAACTAGAGGACTAGTAGCTACGGCTAGAAGACTACCGCTACTCAAGACGTCAAGGAAGTCGGAGACTAAGAGTAGAGATCGTACGCTACGACTCGCGCTAGCGAAGGCGAAGGCTCGGAATAGGAGCCGCAACACAC
Strand-Sequence-112	ACATCCAACACTCTACGCCCGAAGGTAACGAAGACAACTAGAAGAGTTACGCCTAACAAGGCGCGGAACTCGAACTCTCGACTAAGTTCTACGAACAAGCCGCTCCTCAACTCGTCGGCAAGAGCTCGTAACTCGTCCTACTCTACTCGAAGACGTCGAGAACCTACCTAACCTCGAGTTAAGTCGGTACCAACCTCAACTACCTCAACGCGAGAGACGAACGACCTAGCGAATAGGAGCCGCAACACAC
Strand-Sequence-113	ACATCCAACACTCTACGCCCACCAACAAGACTAACAAGACGAGAGAAGCCTAGACTAGAAGGAGACAAGGAAGTCGGAGCGGCGCCGTTCCTCGAAGAAGTAGCTACGAAGCTAAGTCGAGCGAACGAACGAGCCTAGAAGCGTAAGACAACGTCAAGTCGAACGTCTAGAGGTAGGAACCTAGAACTCGGAGGAGGTCGTACGGAGAGAGTCGGTAGAAGAACGGCCTCGAATAGGAGCCGCAACACAC
Strand-Sequence-114	ACATCCAACACTCTACGCCCGAAGACGTCGGTAACGTCTACCTAACGAGCAAGACGACCTAGTAACTAAGGTAGTAAGGCGGAGAGACTCAACGAAGTCTAACTCGACCTAGGTTCAAGGAACAAGAAGTCTAGTAGGAACAACTCTCGTCGACCGTAACGTAAGAGTACGCTAACTAACCTAGGCGGAGTCTCGCGAACGCGTACTAACTCGCTCGGAGTACGACGTACGAATAGGAGCCGCAACACAC
Strand-Sequence-115	ACATCCAACACTCTACGCCCAGTAACGAAGACAACGAACAAGTCGCTCTACAAGAAGGCTAACTAACGAGCTAGAAGTTAAGAAGGTACGGCAACTAGAGCGCGACCAACAACAAGTTAGAACGACTCAAGAGCGAACTACAACTCGGACTACTAAGCGGCTAGTAAGCGAGAGACGGACCTACTAAGAGTCGGAGCGCTACCTCGAGAAGGACCTCGACCGGCCTCGAAGAATAGGAGCCGCAACACAC
Strand-Sequence-116	ACATCCAACACTCTACGCCCAACAAGACTAACAAGACCGAAGAGTTCGCTCGAAGGTAAGACTCGAGCTACGCTCGGAACGTCGCGAGAGAGAGAGACTAGAACGCCGGCAACAAGGCTCGGAGCGAACGATCGAGAGACGCGGAAGGTAACGCTAACGGTAAGTTCGCTCTAACCAAGACGTAAGGTCGGACTCAACAAGTCGCGACGAGACCTCGCTAAGGCCGTTACGAATAGGAGCCGCAACACAC
Strand-Sequence-117	ACATCCAACACTCTACGCCCAACGCCAACAACGCCGCGAGTACTCTCGGACAACAAGAAGGACCTCGCTAAGGATCGTAGTACAACAAGACTAGGTACGAAGCCGTACGACTAAGGTCGAAGTACAAGTAGGAACCTCGACTCTAGACTCTCGAACTACGAACTCGCTCGACTAGTCTCGGCGCGAGCGTCAACGAACAAGACAAGAGCTCGTAAGTCCTACCTCAAGAAGAATAGGAGCCGCAACACAC
Strand-Sequence-118	ACATCCAACACTCTACGCCCAACGAAGACAACGAACGCAACGGTAGTTCGTAGACGTAGAGTTAGAGACTAACGGAACAAGCGAGTTACTCGTAGTAAGGAAGGCGGAGTAACAACGCTAGCGGCAACGCGAGATCGAGGTTCGGTACGTAGTACTAACGACTCGCTACGACGAAGAACGCGAGTCCTAAGAAGAAGAGCGTCGAACTCTCGACGTTCTCGAGGTAGTTAGAATAGGAGCCGCAACACAC
Strand-Sequence-119	ACATCCAACACTCTACGCCCAAGACTAACAAGACCGAAGAGAACGAACCTCTCTAACCTCTCGTCAAGTCGAGCTACGGAAGAACGAGCGAACTACTAAGGTAACTCAAGAAGGAAGGAGACAACAACGGCCTCAACGCCAAGGAAGGTCGGAAGTAAGAAGGCTACAACGCCGTCAAGTTAAGGAAGTTAGAACTCAAGAGTTAGTTCCTACAAGCCGTCGCCGCTAGAGAATAGGAGCCGCAACACAC
Strand-Sequence-120	ACATCCAACACTCTACGCCCAGGAGTAACGTCTAAGCTAGGAACGCTAGGAGACTCGCCAACAAGAACGGAAGTCTAGACGCGAACCTCGTCGCGAGATCGAGGAGCGCGAACGAACTCTCGAGCTAGAGGAGAACGCGGAGAAGAGAGTAGACTAACTCGTACAACGGTCTACGATCGTAGTTAAGGTCGAGGACTAGTTCGACTCAACAACTACCTCCTAGGTAGGAAGAATAGGAGCCGCAACACAC
Strand-Sequence-121	ACATCCAACACTCTACGCCCACCAACAACGCCGCGAGTACTAACGAACTCCTCAACGCCGTCGCTCTCTAACGAGAGTTCCTAAGTAGTTCGTCGACGGAAGTCTAGAGCGAAGCTCGCGGTTAAGGCGGAAGGAGCGGCTCGAACAAGAACTACGGAGAGTCGAGCTAACGAGACGCCAAGACGTAGACGTTAAGACGCGGTAAGACTCTAACGTTCCTCCTCTAAGCTGAATAGGAGCCGCAACACAC
Strand-Sequence-122	ACATCCAACACTCTACGCCCGAAGACAACGAACGCAACGGTAACTACTAACTAAGGTCGTTCCTAAGTAAGAGGTACGAAGGTTAACTAACCGGCAAGTACGTCGTCGCGAGTACCTAGAGTCGGTTAAGGAGTAGGACTAGTAAGGAACGCGGCGAACCTCCTAGAAGTACCAACGGCTAAGCCTAGAGACTCTACCTCAACAACGGAACGACCTAGTAGAGCCTACTAGAATAGGAGCCGCAACACAC
Strand-Sequence-123	ACATCCAACACTCTACGCCCACTAACAAGACCGAAGAGTACGCCAAGTAGTCGACCGCCGTAACCAACGAAGGTCTAGAACTCTCGTCGTTCTAAGAGTAGAACCTCAACGGCCTAAGAGAGTAGACGTCGTTACCTCGGTTAACGAACGCGAAGAGACAAGGCAACTAAGGTAGAAGTACTACCGAAGTCTCGTAACTCGGAAGCGCTCTAACTCGGCGGAACGGCGGCGAATAGGAGCCGCAACACAC
Strand-Sequence-124	ACATCCAACACTCTACGCCCAGTAACGTCTAAGCTCGAAGTCGGTTACAAGAGTCGTAGAACGCGTAGAGGACTCAACAAGTCAAGAAGTACTACGGCTAAGGCGCTCGCTACGCTCTCTCGTACAAGACCAACTAACTCTACAAGGCCAACTAAGTACCTAAGACTACGACCGGTCTAACTAACAAGTAAGGAGACGCCAACTCGACCTAAGGATCGAGTCGGCGGACGGAATAGGAGCCGCAACACAC
Strand-Sequence-125	ACATCCAACACTCTACGCCCAACAACGCCGCGAGTAGACGCAAGTTACGCCTACGACTACTCTCGGAAGTCGAACGCGCTAGACTCGCCAAGAAGAGGTACGAACTAAGACCTACCGGACTACAAGAGTCGAGGAACGAACGCAAGAACGGTCGGACCTACGGTACTCTAAGTAGGACCAAGGACGGTACCGGAAGCTCGACTCGCCTACTACGAAGAGACGGTAGACTCGAATAGGAGCCGCAACACAC
Strand-Sequence-126	ACATCCAACACTCTACGCCCAACAACGAACGCAACCTCGAAGTCTAAGAGACTCGCGCGACTCGGAGAGACAAGGAACGAACGACTAGACTAACGACTCCTAAGTAGACTAAGTTCGGTTACGAAGAAGGAGACGCTAGGAGCGCCGCCGGAAGGACGTTAGAACCTACGTCGAGTTCGTAGTACCTACCTCAACAAGGTTAAGACGCGTTAAGGTCGAGGAGGACCGTCGAATAGGAGCCGCAACACAC
Strand-Sequence-127	ACATCCAACACTCTACGCCCAACAAGACCGAAGAGTTCGCTACTAGTCTAGAACTAAGGTAACTCGCTCGGTTAACGAGAAGGTACGGTAGTTAACAAGAGTTACGAACGTAAGACGTCGCCAAGTTAGAACCTAGAAGCTACGAACGAACGACCTACGGCGGCGTCGGCGGCGCTAGGACCTCGAACGCGAAGAACCTCGCGAGGTTCAACGCGTAGAACGCCGCCGAAGAATAGGAGCCGCAACACAC
Strand-Sequence-128	ACATCCAACACTCTACGCCCAACGTCTAAGCTCGACTAAGTAGTAAGTAGGAAGCGACTACGAGGAGACTAACTCCTAGGAAGAGACGCCTCGGTCTAGAAGTCGGTTACTACGTCGCTACGACGAGCCTCGGATCGAGCTACGCGAAGTTCTAAGAGAGGCGGAGAACTCTCAAGACCGAACTCAAGTTCGGTACGTACGAAGAGAGGAGAGAGTACGCTAGAAGCGTCGAATAGGAGCCGCAACACAC
Strand-Sequence-129	ACATCCAACACTCTACGCCCAACGCCGCGAGTAGACGCAAGAACGTCGTCTAGTACGGCGCTCTCTAAGCCGGAAGGAGGACGTACTAGAGTAGGACCGCTACGTTAAGTACTACTACCGTCGTCCTAAGGCGGTTCGGTACCAACGGTAACTAACTCTCGTAAGTCAAGGAAGCTCGCTCGAGAACCGGCGGCTAGACGACGACCGTCCGTTAGAAGTAACCTAGGACTGAATAGGAGCCGCAACACAC
Strand-Sequence-130	ACATCCAACACTCTACGCCCAACGAACGCAACCTCGAAGTCAACTAGAAGTAACGCTCGTAGACGTAACCTCTACTCGGAAGTTACGCGAACAAGAGGTCGACGTAGAGGAGGAAGTACCTACGCTCGTACGCTACTAAGAAGTACGTTACTCTCTCGAAGACGAGGAGCGCCGTCCTCGGAAGGCGGAACGCTAACTACAACTCGTTCGAAGGTCTCAACGTCGCGAGAGAATAGGAGCCGCAACACAC
Strand-Sequence-131	ACATCCAACACTCTACGCCCAAGACCGAAGAGTTCGCTACTAACGGTTACGGTTCGTACTCGAACGGACTAAGACTCGGCCTCAACCTAGAGAGTACGAGTAACGCCAACGTCGGCTAGTCGTTAGACGGCCTCCTAACGTTCGGTCTAACCGCCGTTAGCGTCAACGGTCCTCCTCAAGGTTAAGGCGCTCTCTCGGAAGGTTAGTAGAGGTACGAAGGTAGCGGTTACGAATAGGAGCCGCAACACAC
Strand-Sequence-132	ACATCCAACACTCTACGCCCAGGTAAGCTCGACTAAGTAGTAACGAAGCTCTCTAACGAACCTAAGGAAGACTCAAGAGACAAGCGTTAGACGGTAGCGTCAAGTCGTAGAGCAAGACGTTCGAACTAGTCAAGCGACAAGCTACCTAACGACGCGCGTCGTCGTAGGAACTAGACGCCGTTAGTACCTCGAGTAAGAGGAGTCTCGGCGGAAGGCGGTTACGATCGACCGAATAGGAGCCGCAACACAC
Strand-Sequence-133	ACATCCAACACTCTACGCCCACCGCGAGTAGACGCAAGAACAACGCGACGTTCGAACGCGAACGCGGTCTAAGAGAGTAGACCGGAAGGAGGACGACGAGTAGTACGTTACGAACGACCTCGAGACCTCAACTCAAGTACGGTAGCTAGTAGTAGAGTAGATCGAACGAACAAGGAGACGCTCGGAGTAGGTAACTAGAAGGACAACCTAGTAGCTAGTCGACTAAGTTAGAATAGGAGCCGCAACACAC
Strand-Sequence-134	ACATCCAACACTCTACGCCCGAACGCAACCTCGAAGTCAACAACTACGGACTCTACGAACTCGCGAGAAGAGAGACCGCCTCGGAACAAGTCGCTCGACCTAGTTCGACGTTAAGTCGGAGTTACGAAGAAGACGGACAAGACCTCGCTAAGACCGAAGGAACCAAGAGCTACGAACCTCCTAGTAGGAGGAGGAGGTTCGGAAGGAGATCGTTCGAACGAACCGGTTACGAATAGGAGCCGCAACACAC
Strand-Sequence-135	ACATCCAACACTCTACGCCCACGAGTAGACGCAAGTCGTAGAAGTACCTACTAACGTACGGACTAGAACCTAGAACGAGACGCGAACGATCGACGTTCAACGGTTACCTCGGATCGAGACTACGCGCTCGCGCCTCGAGTAAGAAGTAACTAAGGAAGTACGGAAGGTCGACCTCGTCGACGTTAAGTAGTACCGTTCGGTTCCTCGGCCTCCTAACTCTCGGACTCTACGAATAGGAGCCGCAACACAC
Strand-Sequence-136	ACATCCAACACTCTACGCCCTAGAACCTCGAAGTCGGAGAAGTCGCCGCTCAACCTAGGAGCAACGCGAAGAGTAGAACCGCCGTTAGGTAGTCGTAGACCAACTAGAGGTAGACCAAGACCGTCGTCTCGAAGTTAAGAACTAGCGCTCGAACCTCGTAGAGAAGACTACTCGTCTAAGCGTAAGCCGTCAAGTTACGCTAACCTCGGACCTCGACGTCGTTCGTCAACGAATAGGAGCCGCAACACAC
Strand-Sequence-137	ACATCCAACACTCTACGCCCGAAGAGTTCGCTACTCTCGGTAAGTTACCTAACGGTTAAGGACGCCTCTCGAAGAAGGAAGGTAGGAAGTAAGGAGAGGAAGGAGAGTAAGCCGTCAAGGAAGGCTAGGAACTCTAGAGCGCCGGTAGCCTACTCGCTAGGTAGAGACTCAAGTAACTAAGTAGGTAACGAAGCGCTAACTCGTACGCGTCGACGTTCGCTCGCGGAAGAGAATAGGAGCCGCAACACAC
Strand-Sequence-138	ACATCCAACACTCTACGCCCACTCGACTAAGTAGCCTCTACGGACGCGCCTAGTTCTCGTAAGGTTACTAACTCTCGAGCGAACTCGGAAGTTCGTCGACTCAAGAAGAGACTCGGTACTACCTCGCTAACGGTAGCTAGTAGAGTAGAACCGTTCTCGAACGCGGTCTCTACTACTCGTCGGAACGCAACGGCGAAGAGGCTCGGTTCGAAGGCTACGCCTCGTACGCTGAATAGGAGCCGCAACACAC
Strand-Sequence-139	ACATCCAACACTCTACGCCCAGTAGACGCAAGTCGTTCGGTCTAAGGCGGCGGAGGACCGTAACCGCGTTCGGCGAAGTCGAACGACCTACCGTTACTAGGTCGTTAAGTCGGTAGTCGAGACCTCGAGAAGCCGGTAGCCTCGAACCTCTACAAGGCTAAGGAGGTAGACGCGCGTCGACGTAGTTACCTAAGAGTAACAACTACGGTCTACGCTAGAGGTTACAAGTCGAATAGGAGCCGCAACACAC
Strand-Sequence-140	ACATCCAACACTCTACGCCCAACCTCGAAGTCGGACTCTAGAGCCTCGGCTAAGAGGAACAAGCGTTAAGAACCGGACTCAAGACTACTAGGACTAGTTCGAGCAAGAACCTCGGTCTAGAAGGTACCGTAACCGGCTAAGTCGCCGCTCGCCTCTAAGGCGGACTAACTAGCTAGGAACTCGCGAGGTTCTCGAGAAGGTAAGCGTAGTAGAAGAGCAACGGAGACGCGGAATAGGAGCCGCAACACAC
Strand-Sequence-141	ACATCCAACACTCTACGCCCAAGTTCGCTACTCTCCTCTAAGTCTACCTCGCTCTCGGTTACGGACGCCTCGAAGGACGCGCGTCGACGGAACCTAGCCTACAAGCCTACTCGAAGTACTACAACAACCTCGGTAACCTAGAGACTCTACAACCTCCTCCTAACGGTACTCCTACTAGAACCGCTACTACCTCGAACTAAGACCGGTCCGAAGGTCTACCTAAGACTAGCGAATAGGAGCCGCAACACAC
Strand-Sequence-142	ACATCCAACACTCTACGCCCTCGTTAAGTAGCCTCCTCGCGACTACTAGCGCTAGAAGAAGACTACCTAGTCTCCTAAGCAACTAAGGTAACTACAACGTCGGCTAACTCCTAGGCGGTTCGAGCGGAAGACCTCTAACTCGCCTACGACGCGGTCGGAGGACGTACTAACTCAACGCTACCGTCCTAGAGAGCGTCGCGTAGAGCTCTAGCGGATCGGAACCGACGTAGGAATAGGAGCCGCAACACAC
Strand-Sequence-143	ACATCCAACACTCTACGCCCAGACGCAAGTCGTTCCTACCTAGTTAGAGTAGAAGTAACTACAAGTAGTTCGTCGGACGCCTACGAGACGCGTTAAGGTTCGTCCTAAGCGGTACTAAGTTAAGCGTCGGACTAACGTACAAGAGTAGAGGTAGATCGTCGAGTTACTAGTAGACTCCTAAGTCGCTCGGCAACCTACTCGCGTTCCTCGCCGGCGGCTACCTAGAGTTAGAATAGGAGCCGCAACACAC
Strand-Sequence-144	ACATCCAACACTCTACGCCCTTCGCTACTCTCCTCTAACTAACCGTCGGTTAGTAAGGTCTACTCTACGCCGGTCTCAACGCGTCGTAAGGAACTCAACGAACTACCGTAGACAAGAGACGCTACGCTCGACGCGGCAAGAACGCTAGCGTCGCGTAACCTAGTACTCGTCTCGTCAAGTAAGAAGGACGCAACCTAAGTAGAGACGGCTCGTTCCTCAACGGCGGACTCGAATAGGAGCCGCAACACAC
Strand-Sequence-145	ACATCCAACACTCTACGCCCTTAAGTAGCCTCCTCGGAGACCTCTACGGAGAGACCGCCGGTTACTAAGTCGGACGCAACGCGGAAGACTACAAGAGAGAGAGTCTCGCCGAACGCTAAGGACGCTAGAAGACGCGTCAAGGACGCGGTCTCCTACCTACGACTACGACCGCGAGACTAAGGACCTACTAACAACGACAAGCTAGAACCGAAGGTTACGCTACTCAACCTGAATAGGAGCCGCAACACAC
Strand-Sequence-146	ACATCCAACACTCTACGCCCTAGAAGTCGTTCCTACTACGCTAAGCTCTAAGACTAGAGTAAGCCTAACGCTACGGAACGACCGCTAGAAGAAGTAAGACTCTAACCAACAACCTCGGAGAGAACGGCGAACTCTAGTTCGGACTACGAACTAGAACGACCGGCTACGCTCGGTCGACGACGAGTAACAACGGCCGGAGTAGGACCGCTAGTACGTTACAAGGTACTACTGAATAGGAGCCGCAACACAC
Strand-Sequence-147	ACATCCAACACTCTACGCCCGAAGTCGGACTCTAGTAGAGATCGTAGACTACGTCGTTAGAAGGCGGTTAGAAGGAAGGAGACTACGCGAGTAAGAGTTAGTAGTCGAGCGGCGCGAAGAGGAAGAGGCGGAGAAGACCTACTAAGAGGTAACGCAAGAGGAGCTACAACGAAGACTAACTCTAAGCCGGCTACGGCGCCGCGTACAAGTCGTCGAGTACGTTACCTCGCGAATAGGAGCCGCAACACAC
Strand-Sequence-148	ACATCCAACACTCTACGCCCACTACTCTCCTCTAAGAAGTCTCGAGACTAGAGTAACGCGGAGAGTTCTAGTACTACGCTCGGACGTAAGGCGTCGAACTAGAGAGGTACGGAGAAGCGAGCCTAGAACGCGCTCAAGAACCTACTAAGTACTACTACTACCTACTCGGTTACGCCAACCTAGACTAGACGAGGACGGAACAAGGACGCTACGAACTCGGCGGAACTAGAGAATAGGAGCCGCAACACAC
Strand-Sequence-149	ACATCCAACACTCTACGCCCAGTAGCCTCCTCGGAACTACTACGTCGTCGAGAGACGAAGTCAAGTAGTACCTAACGAAGACGAACGCCGGCAAGAAGAGAACGAACTAACAACTCCTCGAAGAACCTAACGGCGGAAGTCGGTAAGCCGTCAAGTTCGGACCTCAAGAACTCGCTCGAAGTACCGGAACCGGAAGAAGGTAAGAGAGTCTCTAGAGGAGCTAACGATCGGAATAGGAGCCGCAACACAC
Strand-Sequence-150	ACATCCAACACTCTACGCCCAAGTCGTTCCTACTAAGTACTAGCGCGTCGTACTCGAAGTTCCTAGAACGCCTCGGTAGTACGTTACCTAAGGAAGACGCGTTAACCTAGAGTCTACTACCTCCTCGAACCGCCGTCGAAGGATCGTAGTAAGGCCTACTCGAAGCTACTACTAGGTAAGGCTCGACGAGGAGGTAACTAGACTAGAGTAGCGAAGGAACCGCTAACGTCGAATAGGAGCCGCAACACAC
Strand-Sequence-151	ACATCCAACACTCTACGCCCAGGAGACTCTAGTAGAACGGCGTCGCCAAGTTACCTAGTAGAAGACTCGTCGGTCGGTTCGTCCTCGGTTCGTACGAAGAGGAACGCGGCCTACGAAGCGCCGGCGCGTCGTTCGCTAAGACGAACGTCTAACAAGAACAAGGTAGCGGAAGCGTCAAGACGAGCGGTCTACTCTAGACGAGCAACAAGACTAGCAAGCGTAGTTAGAGAGAATAGGAGCCGCAACACAC
Strand-Sequence-152	ACATCCAACACTCTACGCCCACTCTCCTCTAAGAAGAGAGGACTAACTAGAACCTAACGGAACGCTCGTCGAGGTTCGAAGAAGAGAGAAGAGAAGGTTCGGAAGCTCTCGCCGGCCTCGCCAACGCGACGAAGTAAGCCTAGAAGACCGCTCGGTTAACCGCCTAAGCCGAAGTCGAACGCTACGAAGGTAGTTAAGAACAACAACGAGAGACGAGAACTAGGCGGACCGAATAGGAGCCGCAACACAC
Strand-Sequence-153	ACATCCAACACTCTACGCCCAGCCTCCTCGGAACTAGGACTAGTTACGCGTTCCTAAGAACGTTACTCCTACTAAGGCGGACGACTCGAAGAGAGTCGAGTAACGGTTCGTACTACGCTACTCGGACTAAGAGTAACTAGTACGGTAGAGAGTAAGAAGCCTAAGCCGGAGAGAAGTACTAGGAAGCTCCTAACTACCTAGAGTAGTTCTAGTTACTCGAACAAGAAGACGAATAGGAGCCGCAACACAC
Strand-Sequence-154	ACATCCAACACTCTACGCCCTCGTTCCTACTAAGTACTACCGCCGAAGAGGAACCTCTAACCTCGTAACAAGGTTCGAACGTCGAACCTAACGGTTCGTTCTAGAAGTCGTAAGCTCCTCGCTAAGCCGTCTACTCGAAGTCGGAAGCCGTTAAGAGAAGGTTAACTAAGTTAGACGGCCTAAGTTAACCTCAAGGAACCAACTAACCTCGAACCTACGGTCGGACTACTGAATAGGAGCCGCAACACAC
Strand-Sequence-155	ACATCCAACACTCTACGCCCAGACTCTAGTAGAACGGTCGGCGGACTCCTAGCAACGGAACTACGAAGTAAGAGTAGTTCGGACTCCTCGGAACGACGAGACCTACTAAGGAACGATCGACGTCGACGTCGAGCGGCGGCAAGTTAAGTTACGCGTAGTTACCTCTAACGAAGAACCTACGCCTCGGAAGTAGACGCTAAGCTAGTTACCTACGAGACCTCGTCGGCAACGAATAGGAGCCGCAACACAC
Strand-Sequence-156	ACATCCAACACTCTACGCCCTTCCTCTAAGAAGAGAAGACCGCTAGAAGGAGGTTCGGCAAGTTACGCCTCAAGTAAGCCTAAGGACCTCGCTCGAACAAGTCGTACAAGGAACGCCTCTACGCGACGTTCCTCGGTCGGAGACTCTCGAGAAGAACGGAACAACGAAGACCTCTCTAGAGTAGGAACGCGTACCTAAGCGGTAGTTAAGAACAACAAGGCAACTAAGCGGAATAGGAGCCGCAACACAC
Strand-Sequence-157	ACATCCAACACTCTACGCCCTTCCTCGGAACTAGGAGGACGTAGTTAGAGAACTAAGACGCCGTCCTCGAAGGATCGTTCGAAGACGAAGGTAGTACGACCAAGGAACTAAGCGCGTAGACGTAAGGTCTACTCGTCTAGAGGAAGAACTACGTCCTCTACGGACTCGAACAACAACTAACGTTAAGGTACAAGTTAACCGCGTAAGCGAGGTCGTTAGAGGAAGCCGTTGAATAGGAGCCGCAACACAC
Strand-Sequence-158	ACATCCAACACTCTACGCCCTTCCTACTAAGTACTACTAAGTTCGGCGCTAGCAAGAGAACGTACCTAAGCCTCGGACTCAAGGAACAAGGCAAGTTACTCGGAGAAGTCTAACTCTACGCCGAACCTCTCTAACTCGCTCGATCGTACTCGTTCCTCGTCAAGTTCGAACAACCTCTAACGAGAAGCGCCGCGACCGCTAACGCCTACGGATCGTACTACGCTCTACTAGAATAGGAGCCGCAACACAC
Strand-Sequence-159	ACATCCAACACTCTACGCCCTTCTAGTAGAACGGTAGTCTCTAACTACGCGGATCGAGTACCGAAGTCGCGTTAGAGTTAACGAACTCGACCGGCTAACTAACGTTAACTACTACTCTAAGTAAGAGGCGGACTCCTAGCGCGTACGGCAAGACTCGCTCGTTACTAGAAGAGAGTTAACTCGGAAGTTCGTCGAGAACCTAGTAGACGACGTTAGAGTAGAAGTTCCTAGAATAGGAGCCGCAACACAC
Strand-Sequence-160	ACATCCAACACTCTACGCCCTTCTAAGAAGAGAAGAAGTCGTCGAGTACCGGCGGTAGCGGACCTAAGAGTTAGTCGAGGAGTACGTACGGACAACGCGAAGAACGACTCAAGGAAGACGGAAGCCTACTCAACGGACTCGCCTACGTCCTAACGAGGTACTCGTAAGCTAACGTCAAGTAAGGAAGGTCGAGAGAAGGTAGACAAGCTCTACGCGAAGGTCTAGAGTAAGAATAGGAGCCGCAACACAC
Strand-Sequence-161	ACATCCAACACTCTACGCCCTTCGGAACTAGGAGGAGGCGGTCGACGAAGACTCTAGACCTCGGCGGCAACGGATCGAGTTACCTCGGTAAGAACAACGAAGAAGCTAAGAGTCGGAGTCTCTCGTTAGAACTCTAGTCGAGACTAAGCTACGGAGAAGCCTACGTCTCGACGTTCTAGTAGAACGTCGAAGAAGTCGGCCTAAGCTCGAACTACGGACTCAAGACGTAAGAATAGGAGCCGCAACACAC
Strand-Sequence-162	ACATCCAACACTCTACGCCCTTACTAAGTACTACTACCGGTTCGTACTAGTAAGCGACGTTAAGCGCTAGTAGACCTCAACTACGCGCTCGCGAACCTACCGTACTCTCGAGCGTCTCGACCGAACTCGAACTACAACAAGGTAGCGCCGTCTCGAGGAGCCTAAGACAACCTACCGGTAGAAGATCGACCGCGAGAGAGTACTCGTACGCTAGGAAGACCGTCTAAGTCGAATAGGAGCCGCAACACAC
Strand-Sequence-163	ACATCCAACACTCTACGCCCTAGTAGAACGGTAGTTAACCTCGAAGTTAAGCTAGGTAGTTAAGAACGACCTAACTAAGGTAGAGTTCGAAGACGTTACTCTCGACGAACAACGCTCGACAACCTAACGCTAGCGGTAGTACCTAAGGCTACGAAGAGTTACGCAAGACGTACGAACGCTAGTTCCTACAACTAAGCGGCGCGACTCTCTCGAGCTAACTAACGTAGACGGAATAGGAGCCGCAACACAC
Strand-Sequence-164	ACATCCAACACTCTACGCCCTAAGAAGAGAAGAAGAGAACTCGAACGTTACCTAACGTCGCCGTTCAAGTCTAGTTCTACAAGTTCAAGACGAGCGCGACGACGTCGTTAGAGAAGTTCGCCGGCGTCGCCGAAGGTTAACGCTAGTACGGCTCGACCTACAACGGTCTCTCGAGAAGGAGCTAACGCCTCCTAAGTACCGGCGCTCGCGTCCTACCTAACCTCTCGTAGGAATAGGAGCCGCAACACAC
Strand-Sequence-165	ACATCCAACACTCTACGCCCAGAACTAGGAGGAGGTTAACTCGACTCGGAACTAGCTAACTAGAAGCTAGTCTCTAAGTCGGAAGCTCGTTCAACAACAACGGCGCTAGCGAACTCCTAAGAGACTCGAAGTAAGCTAACGAACGACGCGGCAAGAACGTCGAACGCGCTCGGCGGCGGACGTAAGCGTTACTACCTAAGTAGTAAGAGTCGAGCCTACCTCTCGTCTACGAATAGGAGCCGCAACACAC
Strand-Sequence-166	ACATCCAACACTCTACGCCCTTAAGTACTACTACCTACGGTACGACGAGTTAAGCCTAGAAGTAGTTAAGCGTTCGCTCGAAGAACGGCCTAGAGTTACGCAAGAGACTACGCGGACCTCGAGTTCGCGGACGCGAAGGTCGGCGGTAACAAGACGTCAACAACGGTAGCTACGAAGCGTAGACTACGTTCTAAGGCGGTACCGTACTCGCCTAGTAAGACCTAAGCTAGGAATAGGAGCCGCAACACAC
Strand-Sequence-167	ACATCCAACACTCTACGCCCTAGAACGGTAGTTAAGGCTACGGCGGTAGACGCTACGCTAAGAACGCCGCTACGAGACTAAGACTCGCTAGGAGAAGGAGAGACGTCCTAGAAGGTACCGCGAGCGGAACGACCGGAAGCGTCCTACAAGAAGCGTAGTAACCTACGAAGTACGGCAACGGTAGAACTAAGAGAAGGACTAACGGACTACAAGTCTAGTAACTACAAGCGGAATAGGAGCCGCAACACAC
Strand-Sequence-168	ACATCCAACACTCTACGCCCACTAGGAGGAGGTTAACGACGTAAGACAAGACTCGAGACGGTTAAGGAGAGTTACAAGAAGCGAACGAAGTCAAGAACCTCCTCCTCGTCGGCAAGAACTACGGCGAAGACGGACCTAGTTACCTCGCGACTCGCGCCGTAAGCGCCGAAGGTTCGGAAGAAGACGTCTACGTCCTCGTCTACGCTAGGAAGTACAAGTACAAGAGTAACGAATAGGAGCCGCAACACAC
Strand-Sequence-169	ACATCCAACACTCTACGCCCAGTACTACTACCTACTACTAGACGTAAGGCGTCTCGTCGAAGACCGGTAGTAAGAGCTACGCGAGCAAGTAGAACGTCGGATCGAGGAACTCGAACGCTCCTAGGTTAAGGACTCGAGAACTAGAAGCGAGCGAAGTCTACGGCGGCAACTAGACCGCGAGAAGGCGTAGTAGTTAGAAGAGGACGTAGAGCGCGAACAACCTCGGAGAAGAATAGGAGCCGCAACACAC
Strand-Sequence-170	ACATCCAACACTCTACGCCCAACGGTAGTTAAGGCGGCGCGAGCCTAGAGACCTAAGCCGTCGAAGCTCAAGCCGTCGCCGCCGAAGTCTAAGAGGCCTAAGTCCTAAGTAGCTAAGTCTCGAGTTACAACGCCGTCGGAACCGAAGGAACTCTAGACTAGTTCCTAGAACGAGAGACCGTCGAACCTCCTCTAAGGACCGGACTCGCGTAGAGTAGAAGTAACTCCTAGGAATAGGAGCCGCAACACAC
Strand-Sequence-171	ACATCCAACACTCTACGCCCAAGAAGAAGAGATCGAGGTAGAGGACTAGGTTCTAAGAGAGTTCGTTCGTCAACCTCCTCGCCTACGGCCTCAACAACCTAAGAAGGAGGAACGAACCTAGTAGCAAGGAAGCCGGACAAGTCAACTAACGATCGAGAAGGACTAACCTACAAGCTCGACGCGCCGGTAGGACGAGGAAGACGAAGTTACGCAAGTACAAGTTACTCGAAGAATAGGAGCCGCAACACAC
Strand-Sequence-172	ACATCCAACACTCTACGCCCAGGAGGAGGTTAACGACCGAAGCTCGCGGAGAGACCTAACTCTCGAGGTACCTCCTCGGAGACCTCTAAGGTCTAACCTACGGCAAGAACGGCTACGGAACTCGACAACAAGCCGGAAGCCTCGCCTAAGCTCAAGGAAGCTAGAGTTCGAGTTACGGACTCGCCGTTCGCGGAACTAAGTTAAGGCGGACGAAGAGACAAGACAAGTTAGAATAGGAGCCGCAACACAC
Strand-Sequence-173	ACATCCAACACTCTACGCCCACTACTACCTACTACTAAGCTAGTAGTAGTAGTAGCAACGCTACGAACGAAGAAGCCAAGACCTAGAACGGATCGTTACGCTACGGCGCCGGAACTCGGTTACTCAACTAGACTACTAGAGAGAAGACTAACTACTAGACTCGTTACAAGAGTAACCTCTAACGACGCTAGTACGGAAGACCTACGACGACCGCCGGCAACAAGAGCCTCGAATAGGAGCCGCAACACAC
Strand-Sequence-174	ACATCCAACACTCTACGCCCAGTAGTTAAGGCGGCGCGAGCAACTAAGGAACGTCGTTAAGAACGAACTAGAACGTCGGAACTAACGCTAAGGAACGAGACAAGAACGGTAGGAGAAGCGCCGTCTCGAACGTCTAAGAAGAAGACGAAGTCTAAGACGGACGCTAGTACTACCTACGCGGCTCGTACCTCGGTACTCTAAGAGAAGGTCTAAGCAACGAACTCGCCGCTGAATAGGAGCCGCAACACAC
Strand-Sequence-175	ACATCCAACACTCTACGCCCAAGAAGAGATCGAGGTAGTTAACCGGACGCGCGTCGAGCTAAGAAGACAAGACCGTACGAGAGTAACAACTACGCGGCGCTAACGGTACGAGTCTACTACGCTAAGACTCGTCGAAGAGTCGGAGTACGTTAGACGAACTACTAAGGTCGTCGAGTTAGACGAGCGCCTCGAAGTAGAGCGTCGGCGTCGGCAACGAACGAACTAGTAGAGAATAGGAGCCGCAACACAC
Strand-Sequence-176	ACATCCAACACTCTACGCCCAGGAGGTTAACGACCTAACCTCGGACGTTCGGTAACCTCGAAGCTCAAGAACAAGCGAACTAGAAGTACGGTTAACGCGGACCTCTAACGTTCGAAGCGTAGTACTAAGGCGGCCAACCTCGGAGTAGACTCGGTACCGGCTAACTAAGACAAGACAAGTAGAGCTAAGAGTACCTAAGGTACTAGTAACGACTCTAGTTACAAGACGGCGAATAGGAGCCGCAACACAC
Strand-Sequence-177	ACATCCAACACTCTACGCCCACTACCTACTACTAAGGAAGCGCTACCGCGAGATCGTCGTTAAGACAACTACCTAACGTCGGCAACGCGAACGCGAGCGTCTAGAGAGACGGCTAGACGTACTAGAACTAGAACAACGGAAGGAACTACAACGGAGAAGTTAAGAGAAGGTAGTTAGAGACCGCTAGAAGACAAGACGGTCTCGCTCCTAGGACGAGCGGCAACGTCCTCGAATAGGAGCCGCAACACAC
Strand-Sequence-178	ACATCCAACACTCTACGCCCAGTTAAGGCGGCGCGTTCGTCGGTTACGGTAGCGTCAAGACCGGTTACGGCTACCTCGGCTCGAGACAACCTACTCAAGTCTAGTTACTCAACGGTCTCGCTACTACTAGTAGACAACGCTAAGAGAGACTCAAGTAACCTACGTACGCGAACGCGACCGAAGCTACCTAGACGGAACAAGGCGTCAAGAGTTAGAGAGAAGAGTCGTTAGAATAGGAGCCGCAACACAC
Strand-Sequence-179	ACATCCAACACTCTACGCCCAAGAGATCGAGGTAGTTAAGCGCCGGACTCGCCTAGACTCAACTCGCGTTCCTCGGTCTACCTCTAAGATCGAGCGTCGGCTAGGCTCAAGGTACCGTCCTAAGCGTCGCGAAGAGGTTCGGCAAGTTCTACGTCCTAACTCTACAAGCCGGAGAGTCGAAGACGAAGACGAGAAGCGAAGACGGCAACTAAGGTAAGAGTCAAGCGAGGGAATAGGAGCCGCAACACAC
Strand-Sequence-180	ACATCCAACACTCTACGCCCAGGTTAACGACCTAACGCGTCGAAGCTACTCCTCTACAAGGTAGTAGGAGCCTAACGTAGAGGAAGAAGAAGACTCGAAGAGACGGTTAAGCGAGTCTAACTCAACTCTAACGAGAGACCGCGTAGAGTAAGGAAGCGTCGTCGACTACTCAAGTCGCGTAGTCGTTCTCGACCAAGTTCTAAGGAGAGGAACGACCTCGCCTACGAGAAGAATAGGAGCCGCAACACAC
Strand-Sequence-181	ACATCCAACACTCTACGCCCACCTACTACTAAGGAGAAGCCGCTAGGTACAACGCTCAAGCCGGAACGTAGTACGCCTAAGGAAGCCTAAGGTACGGTAAGAAGAGAAGGAGTTAGTAGACCTCGAGTCTAACTAGCGGTTCGAGAACGAGCTAGAGCGCCAAGAACGCGTACCAAGGAGAGGCCTACTACGCTAACGGCGCCGGACCTCGAAGGACCAACGTCTAAGAGGAATAGGAGCCGCAACACAC
Strand-Sequence-182	ACATCCAACACTCTACGCCCAGATCGAGGTAGTTAAGCGGCGCCGTCGTCCTCTCGAAGTTCAAGTTCCTCAAGTTCGCTCGGACTCCTAACAAGGAAGGCTAACCTCGAACGAGCGGACTAAGTAGCGCTACGAGTTACGAAGCTACTCGCTAACGACAACGCGAAGCCAACTAGTAACCTAGTCTAACGTACCTAGAGAACAACAAGTAGTAGAACGGACTACCTAGAGAATAGGAGCCGCAACACAC
Strand-Sequence-183	ACATCCAACACTCTACGCCCTTAACGACCTAACGCTCGAGGCGGAACTAAGCGAGACCTCGGAGGAGAGAGTTCGCGACCGTTCGGTTCAAGTCGAGTTACGAACTACAACCTAGCGGTAACCTAAGTAGTAGTAGAACTACTACGAACGCCGCTCGGAAGAGCAACGGCGTCGGTCTACGCGGAACTACTCTAAGAAGCGGAACTAGGTTAAGCGGACAACTCAACTAGGAATAGGAGCCGCAACACAC
Strand-Sequence-184	ACATCCAACACTCTACGCCCTACTACTAAGGAGAAGCGAGCAAGAACAACCTAAGAGAGGAAGGTTACGGTAAGAAGAACTACAACTACTAGAACGAACGAAGGAGGACTCTAACTACGTTCCTACTACCTCCTAAGTAGAGGTACGAAGAGAGCTCGACTAGCTCGAGACTACCTAGACGCGGACGCGCCGTTCCTCGGAGAAGAAGGTAGTTAGAGTCGACTCCGTTAGAATAGGAGCCGCAACACAC
Strand-Sequence-185	ACATCCAACACTCTACGCCCTCGAGGTAGTTAAGCTAAGACTAACAACGCTCGAAGACTCGAAGACAACGCGCCGCGGAACCTCCTCGGAGACCTCTCCTCTACGGAAGAAGGAACCTCTCGAACCTCGGTTAAGCCAACTCGAAGAGATCGAGCCTCGAAGCCGGCGTCTCGTTCCTAAGAACTAGCTCGTTACAAGAGAGACAAGAGTCGAGAAGAAGTACTCGAGACGAATAGGAGCCGCAACACAC
Strand-Sequence-186	ACATCCAACACTCTACGCCCACGACCTAACGCTCGACGAAGACGTAAGCCGTCTACGAAGTCAAGAGACCTAACTAAGGCGAAGCGACGAAGGAAGTCTAACGCCTCTCGTCGAGCGCTACCAAGACGACTACTCTCGTCTAAGAAGGAACCGGACAAGACGCTAGTTACAAGTAACCTCGAACGTTAGAGGAACTCTACGGCGTCGCTACCTAGACCTACAAGTTCGCCGAATAGGAGCCGCAACACAC
Strand-Sequence-187	ACATCCAACACTCTACGCCCTACTAAGGAGAAGCGTACGTCTACAACGGTAGCTAACAAGCTACTCGCAACAAGAACGGCGAACCTAAGTAGACTCTCTAGTAACTAAGCAACGTCAAGAAGAGAGAGTTACGAAGAGAGTAGGCTCTCAACAAGTTAACTCGGAACTACCTAGAGAACCTACGAGAAGGAACCGGATCGAAGAGTCTCAACTACGGTTACGCTCTAACTGAATAGGAGCCGCAACACAC
Strand-Sequence-188	ACATCCAACACTCTACGCCCAGCGCGTTCGCTCGCGGTAGCTAGAGAAGGACGAACGCGAGTACGAGTCTAACCTAGAAGTACTAAGAAGAGTACCTAGAGGAGTTCTCGACGTTCAACGCCGCCGTCCTCGAAGAACGCTAACAAGGTAACCTACTAGACGAAGAAGACGGTAGCGTCGCTAGTCTACGCGCGTAAGTCGTCCTACCTAAGAGTACTAGTACGTTCTAGGAATAGGAGCCGCAACACAC
Strand-Sequence-189	ACATCCAACACTCTACGCCCAGGTAGTTAAGCTAAGAGTTCCTCGTCAAGAGTAACGCTCAAGCTCTACAAGGATCGAAGACCGCGAAGTAGTCGTAACTAGACTAAGGTCTCTCGAACGGCCTCGTCGCTCGCAAGAGAAGATCGTCGAGACCTCTCCTCCTACGCGGTACGACCGGCTAAGACTAGAGACAACGCCTAACCTCGACTAGGAGGTAAGGCCTCGGTTACGAATAGGAGCCGCAACACAC
Strand-Sequence-190	ACATCCAACACTCTACGCCCACCTAACGCTCGACGTCGTTCCTAGACGCTAGCTAGTACGCGTAGAGCTCGACTCGGTAGTAACAACCTAGAGACTCGAAGTTAGAGTAGTCGTTACTAAGCAACAACTAGAGGAGAAGCGGTCGGAAGAACGGAGAAGTCGGACGGACGGAAGCGAGCGTCGAAGCCGCGACTAGAACCGAACCTAAGACGTCGAACAAGAGAAGAACGGAATAGGAGCCGCAACACAC
Strand-Sequence-191	ACATCCAACACTCTACGCCCTAAGGAGAAGCGTACGGACTCTACGGAGAGTCGACGAACAACCTCAAGTCGTTAAGAAGAAGTACCGCCTAACCTAAGTACGGCGGAACTAGCGTCCTCCTAAGGTAAGTCGGACTACCTAAGGAACTAACTAGTACCTAGACGACCGCGAGCTACTAGGAACGACGCAAGTTCCTAGGCGGAGCTAACGGAGACTACGTTCCTAAGTTAGAATAGGAGCCGCAACACAC
Strand-Sequence-192	ACATCCAACACTCTACGCCCACGTTCGCTCGCGGTCTCTCGTAGTCGTAACGACTACGCCTAACTCAACTCTAAGGTCTCGGAACGAGGTAGACTAGCAACCTCCTACGCGCTAGCGCCGTTAGAAGACTAGAAGTCGTCCTCTAGTAGTAAGGAGAGTACGAAGAAGACGCTCAAGCTACCAACGTCTACCTAAGCGGAAGGACCGAAGCTCTACAAGACCTAAGGAACGAATAGGAGCCGCAACACAC
Strand-Sequence-193	ACATCCAACACTCTACGCCCTAGTTAAGCTAAGAGTTAAGAGAACCTACCGGTACGTTCTCGAACTACTAGTCGAGCGGTAGAAGGTAGTAGAGGAAGTACCTACGCGGCTACGGAAGCTACGGACGCAAGAACAAGTAGAGTAGAACGACTCTCTCGAGCTAGAACTACAAGTCGACCAACGGACTCTCGAGAACGTCGAGGTTAAGCGTCAAGGAAGGTAAGGAAGAAGAATAGGAGCCGCAACACAC
Strand-Sequence-194	ACATCCAACACTCTACGCCCTAACGCTCGACGTCGTACTCGAAGTCGTCGACGTTCGCCGTACTAAGTACCGCTCAACGAAGTAGTACGAGGTACCTACGAACTAACGCCGTACGAACCTAAGAAGTCGGACCTAGCGCCGTAACCAAGAGCAAGACTCGCTAGACGTTCGCTCTCAAGACCGCCGGTAGGACCGTTAGAGTAACGTCGTAGAGACGCTCGAACGGAGACGAATAGGAGCCGCAACACAC
Strand-Sequence-195	ACATCCAACACTCTACGCCCTTCGCTCGCGGTCTCAAGACTCTAACGACTACGTACTACCTCTAGTAGAGCTCGTTAGAGTTAAGCAACCTAAGCTACTAGACCTACGGCGGTAACAACGAAGGAGAGAGTCTACCTAGGAGACCTAGACTACCTAGTTAAGAGTTACCTCTAAGATCGAACTACTACGGTTAGAGCTACGTCTAAGAAGCGACTCGAACTCGATCGTAAGAATAGGAGCCGCAACACAC
Strand-Sequence-196	ACATCCAACACTCTACGCCCTTAAGCTAAGAGTTAAGGACCGGCTAGACGACCGGTAACGAAGACTACCTAAGGTAGAGTTAACGCTAAGAAGCGTAAGAAGAGTCGAGCGGAAGGTACAACAAGAGAGAGTCGACCGTCGGCCTCTAGTTCGCGTACGAACTCTAGTAAGCGTAAGGCCTCGCTCCTACGAGCGGCTAGTTCGCCTAGTCGACGAACGGAACCGCGACGGAATAGGAGCCGCAACACAC
Strand-Sequence-197	ACATCCAACACTCTACGCCCTAGTCGACGTCGTACGCTAGAAGAGAGTTCGAAGCCTCGAGGAGGACTACTAGGAGTACGAAGAGAGAGTCGACGAGGCGGACTACTAGTACTACCAAGTTAAGGTAGTAGTTAAGAAGGTAGAAGAAGTACTACGAAGCTACGTTCGCGAAGTTCTAGTAACTAGAGAGAGACAACTACTAACGCGAAGAAGGCTACGCCGCGAACGGTGAATAGGAGCCGCAACACAC
Strand-Sequence-198	ACATCCAACACTCTACGCCCGAAGCGTACGGAAGTAGTAGGTAAGCCGTCGCTACTAGACCTCGGTTCTAGAGGACGTAGTACGGACCTAGTTAGAAGAACGTCGCTCGCGTCTAGTAAGCTCGCGAAGGTAACGGCAACAAGTAGAGGTCGAGAGAGACGTTAGAGTTCCTAAGCCTAAGGAACGGTACTCTAGACGTCAAGTAACAAGGCGCTAACTAGTACTCGACCGAATAGGAGCCGCAACACAC
Strand-Sequence-199	ACATCCAACACTCTACGCCCACTCGCGGTCTCAAGAACGGCTCGACCTACTAGAGTCTACTAACGTAGACGACTCGGCGGTAGTAGAGGACGAAGTCGTAGAGTAGGACTCTAGACGAAGCCGCGAAGTACGTCGGTAGTAAGACTAGCGTCCTCAACGGCCGAACGTTCGGCGCTAGAAGACAAGTCGTCGCCGCGGAACAAGTCAAGTAGAGTCGGTAACGCGTACTAGAATAGGAGCCGCAACACAC
Strand-Sequence-200	ACATCCAACACTCTACGCCCAGCTAAGAGTTAAGGAAGAGGACGAACGGCGCTAGAGACGCTCAACTAAGTCTAACCTAGAGCGGACCTAGGTTAACTCTCTCGTCGTAGACCGCCGTTACTCCTCCTCTCGCGAGGTTCTAGGAACGAAGTCTAAGCCTAAGACGCGGAACCTAACGCAAGACCGTTAGGTACGTCTAGAGAACCGCCAACGCCGGAGACGCCGTTAGAGAATAGGAGCCGCAACACAC
Strand-Sequence-201	ACATCCAACACTCTACGCCCTCGACGTCGTACGCTAGGAGTAGCGCTCGGACCGCTCGCGTCTAGAGCAACCTAAGTCTCCTACGACAAGCTCCTCTACAAGGTCTCTAAGAACGCTAGAACGCGGAACGCAAGGAACGATCGTCGACGTAGGAAGCGTAGGAACTCGTCAACTCGAGCCTCGGTAGTACTAAGAAGTTACTAAGTCTAACCTCGAGACTCGTCTAAGGCGAATAGGAGCCGCAACACAC
Strand-Sequence-202	ACATCCAACACTCTACGCCCTAGAGTCTCAAGAACGAAGTCGCTAGCGCTCGCTAAGCTAACTAACAACGCAACGCTCGGAGCGAACTAGACAAGTTCGGAGACGCTAGAGAAGGCAAGTCGACGTTACGACTCTAGTTACGCTAGTAGAGTACCGCTCAAGAGAAGTAGAAGAACAAGTTCAACGAACAAGCGAAGACGACCGGCGCTAGTCAACAACGCCTCGCGTCGGAATAGGAGCCGCAACACAC
Strand-Sequence-203	ACATCCAACACTCTACGCCCTAAGAGTTAAGGAAGACTAGTTAGAGCAACGGTAGCGGCGGCGGTAGACTAGAGAGGAGGAAGACCTAGTAGTAGTCGAGCGCGAGCGAAGAACGCAAGACCTACTACGCCGAAGACTACTAACTCGGCTACGCTCGACAAGCCGCGTTAGACGGTAGTACGTAGTAGCGAAGTACGTTAGAGTAGAGTAGAGACGTCCTAGAGTTCTACGAATAGGAGCCGCAACACAC
Strand-Sequence-204	ACATCCAACACTCTACGCCCACGTCGTACGCTAGGAGCTAGTTCGAAGGCGTCGCTCTCGAAGGCTAGAAGACTAGGTTACAAGGTAACGGACAACCTCAAGAGACTCTCGGTCGGACCAACAACGAACGAAGGAGGACGTTCGGTAGCCTCTACAAGTACAACTAGTAGACCTACAACGGCCTAAGCTAGACTCGCGTCTCGAGTACCGGAAGGACCTAAGCCGCTACGGAATAGGAGCCGCAACACAC
Strand-Sequence-205	ACATCCAACACTCTACGCCCTACGGAAGTAGTACCTCGTAACTAGACCTAACGACTAGGACGACTACCAAGGAAGGTACTCCTAGACTACGAAGAACGTAGTTACCTAGTTAGTACTAAGCGAGGTCGAGATCGAGGACCAACTAAGCGGTCGCGAGTCTCTAGTACAAGTAAGTCTAGTTCCGTCGGAGGACGAGTTAACGACAAGGTTAGACCGCCGGCCTACAAGCTGAATAGGAGCCGCAACACAC
Strand-Sequence-206	ACATCCAACACTCTACGCCCAGTCTCAAGAACGAAGGACAAGGCGCGTCGTCGTTCAACTCGTACTCGAACTAAGGTTAGTAGACTCGAAGGTCGGAAGTCGAAGGTAGGAGCAACGGTAGGAACGCCGCTAGAAGGAGGACCAAGAAGTACCTACGAACCGCTAGGACTAGAAGGTTCGCGTAGAACGCTAACTAAGTCGTCCTCCTCTAAGGCGCTACTCGCCTAAGTGAATAGGAGCCGCAACACAC
Strand-Sequence-207	ACATCCAACACTCTACGCCCAAGTTAAGGAAGACTCTCTAAGGACTCAAGAGAACGTACAAGTACGGTACTAGCCTCTACTACGGCAACGGTCGGCGGTACGCGACTCTACGCGCTAGGTCGTTCTAGACCAACGCTCTAGACGGTTAAGGTACGTTCGCGAGTCTCCTAGAAGGCTAGAGGACCTAAGGTCTCTACCTAACGTAACTACAACGAAGTCTACCTAGAAGAGAATAGGAGCCGCAACACAC
Strand-Sequence-208	ACATCCAACACTCTACGCCCTCGTACGCTAGGAGCCTCGCGTTACAACTACAACCTCTCTAGAGCTAAGAGACGACTACCTAGTAAGGCGGTACGAACTCGTACGAAGCGTACTAGAGTCTCAAGAGAGAAGGACTACAACTCGCTAGACTACAACTACGCTACAACAACGCGTAACTAAGCGCGACTAGGACCTAAGTCGTCTCGACGTCGTACCTCGCCTAGACCTCGGAATAGGAGCCGCAACACAC
Strand-Sequence-209	ACATCCAACACTCTACGCCCTTCAAGAACGAAGGACGCTAAGGTCTACAAGAACAACGCGCTAGATCGACCGCGAGAAGAGAGAGGAGACCTCGACGGAAGAGACTAACTCGAAGTAGGTTCGCCGTAAGTTACGCCAAGAGAGACCTACTAAGAAGAGAAGTCGAAGGCAAGACCGTAAGAGAGGAAGGATCGACTACTACTCGGTAAGAGTTCGCTACTCTAGAAGCGGAATAGGAGCCGCAACACAC
Strand-Sequence-210	ACATCCAACACTCTACGCCCTTAAGGAAGACTCTCTAACAAGCCGCCTACTCGAGTCTAACGAGAAGAGAGAGACGCGTCTACGCTAGCTCGTCGTTAAGCGCGACCGTCTAACGCGCGTTCGAAGGCTAGTTACAAGCCGGACCTAGTAACAACTAAGCGTAGTTAACCGCTACGACTAACAAGAACGGAAGGACTCAAGAGTTCAAGTAACAAGCTCGGAAGAGAACTGAATAGGAGCCGCAACACAC
Strand-Sequence-211	ACATCCAACACTCTACGCCCTACGCTAGGAGCCTCGGAGAACTCTCGTACGGTAAGAAGAAGACGAGCCTCGCCGTAGAGACCTAAGTCAAGTAGGAACCTCTCGCGTTCGCGAGCAACGGTAACGAAGGCTACGAAGCTAGTTACGCCGAAGCGGAAGGCGGTACCTACTCGTAAGCGTACTACTCGTAGTAGTTCGGTTCGTAACTCGTCAACGGTCTACGCTACGTCGAATAGGAGCCGCAACACAC
Strand-Sequence-212	ACATCCAACACTCTACGCCCAGTAGTACCTCGTTACTCGGCTAACGCTAGAACCTACTACCTCTCGAAGGAGAAGGTTAGACTACTACCGTTCTCTACCTCGGTTCGTACGTCGCGAGGCGGAGCTCGTAAGAAGGTCTACTAAGGAACGGAAGTAGTCTCGCCTAGAGACGCAACAAGTAGTCGAGAAGTAAGACGACGTAAGTCGCCTCGAGTCTCGCGAGCGCTAAGGAATAGGAGCCGCAACACAC
Strand-Sequence-213	ACATCCAACACTCTACGCCCAAGAACGAAGGACGCCTCCTCTCGGAAGGCTACGGCCTACGAGACTAAGCGACGAGAGACGGCTAAGAGTTACTCGCCGGAAGCAAGAAGTTAGAACGACCTACGACGTTCGCCGAACGCTACGCTCGGAAGTTACTAAGTCTAGACGAACGCAAGACTCAAGGAAGTCTCGGACGGTCGTACTAAGACAACGCGAAGTCGAGTTAGTTAGAATAGGAGCCGCAACACAC
Strand-Sequence-214	ACATCCAACACTCTACGCCCAGGAAGACTCTCTAACTCCTAACGTAAGCTCTCCTCTACTAGAGCCTAAGGTACGCTAGTAACTACGAAGACGTCAAGTAAGCTCGAGACTAGACCGCCGGACCTCTCGGTTCGACGTTAGAACGCTCGACCGGAGACGCCGCCGCGGAACAAGAGTAGAGTCTAAGCCTCGCTCGGAACCTAGAACTCGGAAGGTCGTCGACGCTAAGCGAATAGGAGCCGCAACACAC
Strand-Sequence-215	ACATCCAACACTCTACGCCCACTAGGAGCCTCGGACTCTACTACGTCTACCTCGCCTACGAAGCGTAGTTACTACGATCGTTCGCGTTAGACGCTCCTCTAACCGCCAAGACTAGTAGCAAGAGACTACAACTCGGAGTAGACGGTTCGACTAGAACGACTACGAAGACCGAACAAGACTAAGGCGGTTCGTAACAAGCTACCGCCGTCTAGAAGACGAACGGAAGTTCGGAATAGGAGCCGCAACACAC
Strand-Sequence-216	ACATCCAACACTCTACGCCCAGTACCTCGTTACTCCTCGGCGGTAACGCGTAGTTAACGGTAAGACAACAAGGACAACAAGAGTTCTAGAACGCTACGACTAGTCTACTACTCAACCTAGACGTCGCCGGACCTCGGAACAAGAACGCGTTCGAAGGAGAAGACGTCTCGTAGTAACGCTAAGAAGTCGAACGACCTCAACGAACTCGGTACCTCCTCTACAAGTTACGCGAATAGGAGCCGCAACACAC
Strand-Sequence-217	ACATCCAACACTCTACGCCCAACGAAGGACGCCTCCTCCTCGCCTAGACGTTCTACCTCGGCGGTTAGAACAAGGAACAAGGCGTCGCTAGTCTAACTACTCGCTAGTAACAAGCCTAAGCCTACGCGACCGCGTTAAGTAGGAGCTAACGCAACGAACAAGACAAGTAAGCCGTTAGCTCGGAACCTCAAGCTACTCGAACGTTCGCGACTCTCGGCTCGTAACGATCGGAATAGGAGCCGCAACACAC
Strand-Sequence-218	ACATCCAACACTCTACGCCCAGGAGCCTCGGACTCCTCTAGACTCGGAGCGTCGGTCTCGAACTCGTCTACGCTCCTCGCGGATCGAGACAACAAGGTCGGAAGAAGAGCAAGTCGTAGAACCTAGAGAGGTTCTAGTAGAGTACGTAGTAGACGTACAAGAACGCGTTCTCGAGAAGAAGGAGAACGACGTTCAAGAGGAAGAAGACGAACGGCTCGAGTTAGTACGCTGAATAGGAGCCGCAACACAC
Strand-Sequence-219	ACATCCAACACTCTACGCCCACCTCGTTACTCCTCCTCGAAGGTACTAGTACCGGACTAACGTCGACTAAGGAAGCTAGTCTCGAACCTAGACCTCTAGACAACTAAGGCCTCCTACTCGGAAGGAACGAAGGAACCGAACTCCTACTAAGACGCGGCTAGGAAGCTCGGAAGAGTACGAGTTCGTTCGCTCGACCTACGACGAACGGACGCTAGAGCAAGAGAGAACGAGAATAGGAGCCGCAACACAC
Strand-Sequence-220	ACATCCAACACTCTACGCCCGAAGGACGCCTCCTCCTCGCCAACTAGTTACGATCGTAACGCTAACCTCGAAGCGGCGCTCGAAGTCTAAGAGAGTAAGGTTACGCTAGTAGCTCGACGAGAGAAGGAGAACTCTAAGCGAGAGAGAGGACCTAACTCGAACTACGCTAACGCTAGACTAAGAAGTAGTTCGGCTAACAAGGAAGTAGCCGAAGTAGCTACGCGAGGACCGAATAGGAGCCGCAACACAC
Strand-Sequence-221	ACATCCAACACTCTACGCCCACTCTCTAACTCCTCCTAACGACCGAACCTCTAAGTCTACGAGAGACTAGTACGTTAAGGAAGACTACTAACGGTTAGAGCTAGTACGTCAAGAGAGAAGACGCTCGGTACGGTACTCAAGAGTAGAGCTAAGCCGTACAAGCGAGTAGTTACCTACTAAGGACTAGCGGACTCGGCCTAAGTACGACGAACGGTCTACTAGAAGAAGCCGAATAGGAGCCGCAACACAC
Strand-Sequence-222	ACATCCAACACTCTACGCCCAGCCTCGGACTCCTCTACTACGAAGGCAACCTCGTCTACGCTACCGTAGAGTTAGAAGCTAGGTTACTAAGGTAAGAGTACGGCCTCTACAAGACCTACGCTCTCTAACGCAACGCGACTAAGAGACAACCTAGGACTAGGACCGTTCGACCTACTAACGCGAAGACGAACTACAAGTAACTCTCGAAGACGTTAGACGCGAACGAACCTGAATAGGAGCCGCAACACAC
Strand-Sequence-223	ACATCCAACACTCTACGCCCTCGTTACTCCTCCTCGGCGCCAAGTTCGGTTAGAACTACGCGACGAGTAGTTAGTTAACGTACGTCTAACCTACTAGACTCGGCTAACAACTAACTAGCAACTCGAAGAACAAGAACTAGACGTCGACTCGCGCTACCAAGACCGGTTACGGTAGGAGCTCGACGTTCTAAGACGGAACCTCGAGCTAAGAAGGCTCGAGAGACGGCCTCGAATAGGAGCCGCAACACAC
Strand-Sequence-224	ACATCCAACACTCTACGCCCAGACGCCTCCTCCTCGTCGAAGTCTCGAAGGAACTACCTACTCGGTCGTAGTTCTCGTTACTCCTCAACTCGACGAGAACCGTCCTACTAAGGACTCAACTACCTCCTACTAACGGTTAGTAGAGCTCGTAAGAACCTCCTCTCGAAGGCGTCGGTAGACAAGTCCTCGCCGCGACGTTACTACGCGGCGAAGAGACCAACTAAGGAAGGGAATAGGAGCCGCAACACAC
Strand-Sequence-225	ACATCCAACACTCTACGCCCTTCTAACTCCTCCTAACCGCTACTCTCTACCTACTCGGCAAGAGTTCGAGGTAGAAGACTCAAGGATCGAACGGTCTCTAGAGCGCTCAAGGTTACTCGTCGAGAAGGTAACAACTAGAGTTCGCGAGTTACGGCTACGCGTACAAGTACAACCTAACCGCGACCGGTCTACAAGAGACGTCGTAGGAAGACGTCCTCGCCAAGAAGAGTGAATAGGAGCCGCAACACAC
Strand-Sequence-226	ACATCCAACACTCTACGCCCTTCGGACTCCTCTACGAAGCTCGCGCGTTAAGAGAGTAACAACGCTACTACTAACGCGCTAGTTAAGACTCGTTAACGAACCTAAGGACCGCTACTCAAGCGTAGAGCGGAGAGTAGAGCCTCGGTTACCTCGAAGAGTAGAGTTAGTCGAAGACGAGAACTAGGTACAAGTAAGCTAGTCAAGCCTAAGCTAGAGACGTCGGCCTCGCGGAATAGGAGCCGCAACACAC
Strand-Sequence-227	ACATCCAACACTCTACGCCCTTACTCCTCCTCGGCGCTACCGTAACTCGCGAACTCTACTAGACCGCCAACAAGAGGAGCTCGAACAACGGCGGAGAGAAGTACAAGAGTCGGACCTCGGAACTAAGAGAAGAGTTCGCCTCGTTACTAACGAGACGCAACTACTAGAACAAGTCGTCGACGTACTAAGAAGGCTCGAGGTTCCTACGAACTCGCAACGGCTAAGCGACTGAATAGGAGCCGCAACACAC
Strand-Sequence-228	ACATCCAACACTCTACGCCCTAGTTCCTCCTCGTCGGTAGACAAGCCGGCAAGTTCTAACGAAGCCTACGCGGATCGAGCCTCGAAGTCGTCGCTCCTCGGACCGTACAAGCGTACGTCTAACTCGCTAACGCCAAGTAGACGTTAACCAAGTTAGAGTCGGAAGCTCGCGGAAGAACCTACGAACAAGGCTCGTTACTAACCTACTAAGGCGTCGAACTACCTCTAGACGAATAGGAGCCGCAACACAC
Strand-Sequence-229	ACATCCAACACTCTACGCCCTAACTCCTCCTAACCAACTCGTCGAAGTTCGGAGAGTAGACGAGTACGTAACGCAACTAACTCGGTAGGTACGGACTACTCCTAGACGGAAGGTAGTTCTAGTACTCGACCAAGTTCAAGTCGTTCCTAGAAGAGACCGGAGAGAGCCTCGCCGGCCTACTAACGAAGAACGGTAGACAAGGTCTACAAGAAGAGTCGGAAGACGCTACGGAATAGGAGCCGCAACACAC
Strand-Sequence-230	ACATCCAACACTCTACGCCCAGACTCCTCTACGAAGACGAACGACTCTCGTACCTACAAGAGAGCAAGTAACTAAGCGCTCGGACGAAGAGGAGCGCGTACTCGACTCTACAAGAACCTCCTAGGTAAGAAGACGGTCGGTAAGACGGTTACCTAGACGCGAACAACTAAGTCTAAGTCAACTAAGAGACTACTCGGACCTACGGCGGACGGAACGGTTAACTAAGTACGGAATAGGAGCCGCAACACAC
Strand-Sequence-231	ACATCCAACACTCTACGCCCTTCCTCCTCGGCGCTAAGACTACGGAAGCGTAGTTAAGTACTCGACGCGGTCTAAGTTAGGAAGGATCGTACTCGAGGAGTTCGAGAAGTTCGTCGACGAGTCTCTAGTTACTAAGAGAACGACTAGAGTTACTAACTCTAAGAACGTAAGTCGCGTTACTAGCTACTCTAAGTTAACTCTACTCGGAACCTAAGGAAGTCTCGACGACGGAATAGGAGCCGCAACACAC
Strand-Sequence-232	ACATCCAACACTCTACGCCCTTCCTCCTCGTCGGTAGGACTAGCGCTAGACTACGCAAGAACCTCTCGTTACGCCTACGCTACGAAGTCGGTACCTAGAGAACTCGGAAGAACGGTACTAGCTCCGGCAAGTACAACGCGTTAAGTTAGTTCTACGCTCGGAGGAACGTCGTCTACCTCGAAGAAGAACAAGGCGAAGGTTCGAGGAGGTAGTTCAAGTAGGAACTCTAGGAATAGGAGCCGCAACACAC
Strand-Sequence-233	ACATCCAACACTCTACGCCCTTCCTCCTAACCAACGCTACCGGAGAAGAAGACGAACTCGTCAACGCTCAACAAGGCTAGACCGGAAGCGGAAGCTAAGGCGCCGCCGCGGAAGACGTCTAGAGTACCTACGTCGCGACTACGAAGACGACGAGGAACCTACTCGCCGTTCAAGCTCGCGAAGGTAGGTCTACTAAGTTCAACGGAAGCCTACCTAAGAGAAGAACGAAGGAATAGGAGCCGCAACACAC
Strand-Sequence-234	ACATCCAACACTCTACGCCCTTCCTCTACGAAGACGGTACGTAAGCTACGAGTACGAGTAGAACCTCGAACGCCGGCGCGGAAGCTCTCAAGTAGAGAGGTACGAGTAGGTACTAGTCGTAGTACCTACGACTAACCGCCGGAAGGAGGAGAAGCGGTAGTACGAGACTCTAAGCGAGGAAGACCAAGAGCGCTACTCGCGAAGCCGGCAACGAACGAGAACTCAAGAACGAATAGGAGCCGCAACACAC
Strand-Sequence-235	ACATCCAACACTCTACGCCCTTCCTCGGCGCTAAGAACAAGTCGAGACGCGAAGTCGGAAGTCTCGAACCTAGTACTACTCTAAGAAGGAGGTACGGACTAACTAACGCCGCTACCGGCCTACGATCGTAGACTCGAGACTAGTAGTTAGAGTAGACTAGAAGGACTAAGTACAACGGAGAGTAGAGACAAGGCTAGTCGTCGAGTCGGAACGGAGACGGAACCAAGTACGAATAGGAGCCGCAACACAC
Strand-Sequence-236	ACATCCAACACTCTACGCCCTTCCTCGTCGGTAGGAACCTACGAAGTTACGAAGAGAAGTTCCTAGACCTCAACCTCGAAGGCCTCTAAGAAGACGGCCTCTACCTAACTCGCGAAGGCAAGACTAAGTTCGAACGCCTAAGCGAAGAGAGACTAGACGCGTAGAGGACGACCTAACCTACCTAGACCGCTACCGCGACTACCGAAGGTTAAGTCGGAACCAACTCGTACGAATAGGAGCCGCAACACAC
Strand-Sequence-237	ACATCCAACACTCTACGCCCTTCCTAACCAACGCTAAGAACTCGAGTACTCGAGAGAGTAACAACCGAAGTAGTACTACTCGACTACTACAAGGCGTCGGTCGGTAGTAACCTAGGTCGTCGTTCGGCCTCGCGTCGAAGTTACCTCTAACCGGTAAGACTCCTCGGACTCTCGGAGAGAACCTCGGCTCTAGTTACAACTCGACCAACGGAAGACAAGCCGCCGCTACCGAATAGGAGCCGCAACACAC
Strand-Sequence-238	ACATCCAACACTCTACGCCCTTCTACGAAGACGGTAGGTACTCGTAAGCGTCGAGTACTAACGGTAACCTAACGTACAACGGATCGAACCTACCTACGAGCGCCGCGACCGGACTCGTCGTCGTCTACGGCGAACAAGGATCGGAACCTCTCTAGAGCAAGAAGACCTACGTCGGAGAAGAGTAAGAAGCGAAGTTAGAGGAAGGCGGATCGAGAAGCGCGAAGAGACGCGAATAGGAGCCGCAACACAC
Strand-Sequence-239	ACATCCAACACTCTACGCCCTTCGGCGCTAAGAACGCCGCTCGAAGACCTACGTACGAAGAACCTAAGTAAGAAGAGTTCGCTAGGTTAACCGCCTAGACGACCGCGTAGTCGAGAGAAGACAAGTCGTACGAAGGAAGTACTAGACGCCTCGGACGCGCTCTAGAAGACGCTCGGTAGACCGGTTAAGACTACCTCCTACCTCCTACGAACCTAGACTCGTTCGGAGAAGAATAGGAGCCGCAACACAC
Strand-Sequence-240	ACATCCAACACTCTACGCCCTTCGTCGGTAGGAACGAAGCTCGAAGTAGCAACGGCTACGTCGCTCGAGGTAACGCTAGGAGAAGAAGGCGGTCGAGTAACGCTCTCGCGGAAGAAGCTCTAGAGAGCCTCTACTAAGAGTACAACTAGTACGAAGGCTAACGCGGTAACGTCGAAGTCGAAGTCGAACGCGGCTAGAGGAGGAGGAAGTTCTCGACCTAGACTCGGAGTGAATAGGAGCCGCAACACAC
Strand-Sequence-241	ACATCCAACACTCTACGCCCTTAACCAACGCTAAGACTACTCGACTCCTACGACGCGAAGGTTAGGAACTAGAGAGGTACAAGGAAGGTAGAACGGAACGCCTACGCGTCTCGAGTCTCGCCGAACGAACCGTCGCGAGCGTCTCGTAGTCGTTCTACTACTACGAACTAGAAGCCGCCGTAACGTAGACGAACGGCCTACCTCTCTCGTTAGAGTACGGCTAGAAGTCGGAATAGGAGCCGCAACACAC
Strand-Sequence-242	ACATCCAACACTCTACGCCCTACGAAGACGGTAGGAGTACTCGAAGATCGTTAGAAGGTTAAGGCGGCTAAGGTAACTACGCTACGTTCCTAGAAGGACCTAACGGTACGAACTCGTAGTACTAGAACAAGTCGTCGAGGAACGCCAACTACGGTACTCTCAAGTCGTAAGAGAGCTCGAGTAGATCGTACTACGCTAGGAACGGTTAACTACTCGCTAGGAGCAAGAAGGAATAGGAGCCGCAACACAC
Strand-Sequence-243	ACATCCAACACTCTACGCCCAGCGCTAAGAACGCCAACGCTCGAAGTAGTACGACTCCTAAGTCGACTAGCTAAGCCGTTCCTCGCTAACAAGACGCCGTCTAGTAACGAAGGAACGGACAAGAGTTAAGGAGATCGTTCTACGGAAGCGCCTCGAAGACCTAAGGTCGGACTAGCGCGAGTACTCTCGGCTAGAACAACCTCGCCTAAGACGCCTAGTTCGAAGCCGGTGAATAGGAGCCGCAACACAC
Strand-Sequence-244	ACATCCAACACTCTACGCCCACCAACGCTAAGACTAACGGTACGGAAGGAGAAGAGAGCTCGTACCTACTCTCGTTACGCGCGAGACAAGCCAAGAGTTAGACGTAAGAACTCGTCGGCGCCTAAGCTCGGACCAAGAGTTCGAGAGAAGCTAGTTAGGCGTAGTTAAGAACTCTAAGAGTTAACAACGCTCGACTCAACTCGAAGACCTCGAGGTTAGACAACAACAAGGAATAGGAGCCGCAACACAC
Strand-Sequence-245	ACATCCAACACTCTACGCCCGAAGACGGTAGGAGTAAGAACTACGCTAGCGGACTCGCGACTAGGTACTAGTAGTAGAACTCGAAGAGCCTCGGCCTCTCGTACGCCTCGTTAGACGCGTAGTTAACGAGAGACTACCTAAGAGAAGAGTTCTAAGACTCGTTCGAACCTCCTCAAGCCGGTAAGTAACGACTCTCGTTCTAAGGACAAGCGAGACTCGCGAAGAGTACGGAATAGGAGCCGCAACACAC
Strand-Sequence-246	ACATCCAACACTCTACGCCCACTAAGAACGCCAACGTCTAGTAGAAGACCTCGTAACCTAGGTTAAGCGGCTAGTTCTAGTTCGCTAACGGAAGTCGGTACGCGTTCCTCTACGTCAAGTACGGTACTAGTTAACGAGAACGCGTCAAGAGGACCGTCAAGGTCTACCTACTCGTCGGAACTCAACGCCTCGGACTAGAGACCGCTAACGCGTAACGAAGTCTAACCGGCGAATAGGAGCCGCAACACAC
Strand-Sequence-247	ACATCCAACACTCTACGCCCAGTAGGAACGAAGACGCCTAAGAAGAGAAGTAGAGGAAGTTACTAGACGAAGGTCGGAGGTACGTCAACTAGTCGAGAACCGGTACTAGGAAGTAACTAAGACCTACTACTAACTACGCTCGACCTAGTACTAGAAGAAGTCTCGCTAGGTTCGAAGACGGAAGGTAGTACGCGTTAGAGTTCGCTCGACTAAGGTAAGTCAAGACGTAAGAATAGGAGCCGCAACACAC
Strand-Sequence-248	ACATCCAACACTCTACGCCCAACGCTAAGACTAACTAACAAGAGAGCGCCGGCTACGGAACGAGGACTCAAGCCTAAGCTACTCCTCTAGACCTAAGTACTAGGAGAAGGTAGTAGTTCCTACTAACTCGCGGACTCTACGCGAGTAGCAAGACCAAGAACGTCGCTACTAGTAACCTAACCAAGAGTCTAGAGTAGTACGAACCTCCTAGTAGCGGCGGTAACCAACAAGAATAGGAGCCGCAACACAC
Strand-Sequence-249	ACATCCAACACTCTACGCCCAACGGTAGGAGTAAGAGAACGAGGAGTACCGTAGAACAACTACTCAAGTTACAAGAAGGCGCGAACGGCGAACGAGACGGAAGTTACTACAAGAGGAGCGGAACTAACGAAGGCTAGAGTCTCTACCTAGAGTTACGCGCGAGCAAGAACCTCTCGAGGTCGACTCAACGCCTCTACGGAACTAAGTAGTTCGGCTAGACGTTCGGTTAAGAATAGGAGCCGCAACACAC
Strand-Sequence-250	ACATCCAACACTCTACGCCCAAGAACGCCAACGTCCTACCTACTACGAAGACGTAACGCTACGCGAACGGAACCAAGAGTTACGGTACTAAGAAGGAAGTCGAAGTCGCTAAGAGAACGTCGACGACCTAGAAGACTAACGGAAGGAGACTCTAACTAAGCTCGTTAAGGTTCGCCGGTTAACGAGACGTCAACGGTAACTACAACCTCCTCCTCGGTTCGTACTAACAAGAATAGGAGCCGCAACACAC
Strand-Sequence-251	ACATCCAACACTCTACGCCCAGGAACGAAGACGCCTAGAGTAGTACGTAACAACAACTCGAAGAGTTAAGAACTCCTAGTAGATCGAAGTAGTAGACCGCTCAAGACCTAAGGTTAACCGGTTACGGTAAGACCGCGTTCTAGAACTAAGCGTACGGACAAGTCGGTACCGGCGCGAGTAGAAGAAGACCTCGCGCTACGTAGTACGGACTAACGAGAAGAGGAAGGTTAGAATAGGAGCCGCAACACAC
Strand-Sequence-252	ACATCCAACACTCTACGCCCACTAAGACTAACTAACAAGAGAACTAACGCGCCAACGCGACCGTAACCAACTCGGAAGCTCTCGCGACGACTCGAAGTAACGAAGAAGCGAAGACGTACTACCTCGGTAGGAGAACGACTAAGGCTACCGTTCCTAGTAACGGCGTCGCCGCCGCGTCGACTCGAGACTACGGCTAAGCGAGCGAAGTCGAACCGACTAAGTCGGAACGAGAATAGGAGCCGCAACACAC
Strand-Sequence-253	ACATCCAACACTCTACGCCCAGTAGGAGTAAGAGAACGAGGAACGCCGGTCGGTAGAAGTACTACGTCGTCGAAGACGGCGCTCGGAGGCGGTCGACGGAAGAACCTCGAGACGGCTCCGGCTAGTTCTAAGAGTACTACGAACAACGCGCGACGTACCTCGGCTACCTAGAGAGGTCGAGAACTAGAAGAGACTAGACTAACGGCTCTAGAGAGAGAAGTACGTAGTTCGAATAGGAGCCGCAACACAC
Strand-Sequence-254	ACATCCAACACTCTACGCCCAACGCCAACGTCCTACCTAGTACCGCCGTTAGACAAGCTCGAAGTAGCGCTAGAGACTAAGAAGGTAAGAACTACTAGAGCGCCGCTAGGAACAAGTAGACCTCGAGGCGGAGCCTAGAACTAGAGTCGACGTAACAAGAGACTCGACTCGGCCTAGAAGAACGAAGCGCTAGGCGGTAAGCTAGTAGAAGAACTCGAAGGAGCTCGTACGAATAGGAGCCGCAACACAC
Strand-Sequence-255	ACATCCAACACTCTACGCCCAACGAAGACGCCTAGAGCAACGAACAACGAGAACGCTAACGCTAGTTACCTACGACGAAGAAGAGAAGGAGCGGCGAAGCGACCAACGGACTACTCCTCGCGAGTCGGTAAGAGAGCAAGTAGACCGAAGCGGCCGGATCGTAAGAGACCGTTAGGACGACGTTAACGACTCCTAGGTCGTTAAGACGCTACGGTTAGTTCCTACGACCTGAATAGGAGCCGCAACACAC
Strand-Sequence-256	ACATCCAACACTCTACGCCCAAGACTAACTAACAAGTCAAGACTCTCGCGGAAGCCGGCTCGAGGAACGGCGCTCGGCGGACCGGCGCCAAGTCGTAGAGACCTCTCTAGTAAGGCTACGTCTACGGCGCGTCGTCGTCGTCGTTCCTAAGTACGTAGAGCGCCGAACAACTAAGGTACGGTTAGAGTAGGAGTTCTAGAAGGTAAGAACTACGACAACGCGGTTCTCTAGAATAGGAGCCGCAACACAC
Strand-Sequence-257	ACATCCAACACTCTACGCCCAGGAGTAAGAGAACGTCCGTCGGTAAGTTCTCGTAGAGAAGAACGTTCGCTCCTCGAACGTTACGAACCGTAGAAGCCTCGTACGCCTAGACCTAGTCGTAGACGAGGAGTACCGCGTAGTTAGAACCTAGCGCGACTACTAGGTAGTCGACCGAAGTCGCTCGACAAGCCGGCCTCGCTCTAAGCCTAAGGTCTAGACGCTCGACGAACGAATAGGAGCCGCAACACAC
Strand-Sequence-258	ACATCCAACACTCTACGCCCACCAACGTCCTACCTAGTACCAACGAACCTCGGAAGACCTAAGTCGGAACCAAGAGGTAGGAAGACAAGTAAGAGAGGAGCTCGTAGTTCAAGACCGGCGGTCTACTCGGCGCCTACCTCTAAGGACTACAAGGTAACGTCTAACCTAAGACGAGAGACGTCTACTACTAGTTCGTCGGCGAAGACGTTACTACTCGGTAACGACTAAGGGAATAGGAGCCGCAACACAC
Strand-Sequence-259	ACATCCAACACTCTACGCCCGAAGACGCCTAGAGCAACGAAGACAACGAACGCCTAAGTACGAGCTACAAGTACTAGAGTACCAACGAAGGTCGGCGGTAACAACTCGTCGTCTAACAAGTCGGTTCGTAAGGCCTCTAACTAAGGAGGACCGTAAGGACTCCTCGCCTACGACCTCAAGGCTAGTCGGAACAACGCGCTAAGTCGAGTAACAAGAAGTTCAACGGAAGTGAATAGGAGCCGCAACACAC
Strand-Sequence-260	ACATCCAACACTCTACGCCCACTAACTAACAAGTCAAGAGTACCGCCGCCGCTCAACTAAGACCTACGTTCTCGTAGACGAGTAAGAGCAAGACCGTACCTAGCAACGTCTCGAGGTAGGAACTAGCTAACGGCGGAGACCTAAGAGAAGGTAAGTAGAGTAAGACTCGGCGGTTAGAGACGACGTAGAGAACCTACGGTTACGGCGAACGCAACCTCCTAGACTACCTAGAATAGGAGCCGCAACACAC
Strand-Sequence-261	ACATCCAACACTCTACGCCCAGTAAGAGAACGACTCGAGACGAACTAACTAGCAAGTACGGTCTAACTCGGTAGAAGTAGTACAAGACGGAAGACGTCGGCCTCTACGTCTAAGCCGAAGCGAACCTAGAGTAGAACGGAAGACGCCTCTCGACGTACTACTCGTAGACGTCGTTCAAGACTCCTCGACAACGCCTCGCTCGGACTAGTTACGCGAGCTACTCGAGAGACGAATAGGAGCCGCAACACAC
Strand-Sequence-262	ACATCCAACACTCTACGCCCAACGTCCTACCTAGTACGTAGAAGTCGTTCGGACTCTAGTCGAACGCGAGGACCAAGTTACCTCGCGAACAAGAAGAACTACGACTCGCCGCTACGACTCGACGCGGTTAAGGACGCGCTCTCTACCTCGCCAACTAGTCGTCGACGTAAGACGCGTACGCTAGAGACTAGAGAAGGTAGTTCTAGTCGACGAACGGTTCGTCGAGCGGAGAATAGGAGCCGCAACACAC
Strand-Sequence-263	ACATCCAACACTCTACGCCCAACGCCTAGAGCAACTAGGAAGTCCTCAAGAGCAAGAGCGGCTAACTCGTCAAGTACGAAGACGCGAACAAGACGAGCGTCAAGAGATCGACGGAAGTCGCCGAACCTCCTCGGAGCGGCGGAGAGGAAGTCGAAGAGTTACTAACTACCGGCGGCGCGACCTCGTCGTCGTAGAGAGAGTTAGTAACTCTCTCGTAACAAGAGAGGTCTGAATAGGAGCCGCAACACAC
Strand-Sequence-264	ACATCCAACACTCTACGCCCAACTAACAAGTCAAGTAAGCTACTACCGGTCTCTAGAGGTACGCCGGAGAAGTCCTCGAACAACGCTCGACTCGGAGTAGTAGAAGTCGGAAGAGTTCGTCGACTAGGTCGGAAGCGAACAACGGTAACGCCTACTCGAGGACTACCTACAAGTACAACTCGGAACGAACGTACCTAGAGAGCGGTTACGCCGCTAACCTACTAGACTAAGAATAGGAGCCGCAACACAC
Strand-Sequence-265	ACATCCAACACTCTACGCCCAAGAGAACGACTCGAACGAGTAGTCTCGGAACCGGTTAAGTCGGTTAAGACGCTAACGAAGGTACCGGCGGCTAACCTACTACGAGGTTACGCAAGAGTTAACAAGGCTAAGCGACCGTCGGAAGGTTACGAAGAACCGCGAGCTAGAACGAAGCTCGCGAAGGCGCGACGTACTAAGAGAGGACCTAACTAGACGGTAGGTTAACTCTCGAATAGGAGCCGCAACACAC
Strand-Sequence-266	ACATCCAACACTCTACGCCCAGGTTACCTAGTACGTAGAAGAACCTAACGAACTACCTCGGCGCTAGCGCCTCGTAGAACCTAAGAGACGTCGGCGTCGGTAGCGTCAACTAGAGCGTCGTCGGCTCTAGGACCGTTACGACTACGACCGGCTAACGACTAAGTACCGGTTACTAAGACGAAGAGTTACAAGCGTAAGGCGAACCTCGGAGGTACGTCGGAGACGCTACGGAATAGGAGCCGCAACACAC
Strand-Sequence-267	ACATCCAACACTCTACGCCCACCTAGAGCAACTAGGAAGTCAACGCCAAGTAAGAACCTCGCGCTCGCAAGTCGAGTCTAACCTAACAAGGAAGACTCGGCCTAAGGAGTAGGTACGGTCGGAAGAAGTAGTAGAAGTTCGGAGACCTAAGTACTCGCGAAGACGAAGTCTACCTACGCCTAACTCCTCTCCTCGGACTAAGGTACGGCGCGTAAGAAGTCTCGTAAGGTGAATAGGAGCCGCAACACAC
Strand-Sequence-268	ACATCCAACACTCTACGCCCTAACAAGTCAAGTAAGCTACTAACGCTAGTTCGTCGTACGGCGCTAGACCTACCTAAGGCGGTAAGACGAGGAGGAGCGCGAGCGCGTAAGTCGCCTCGTTAACGACTACTCGGTAGACCGGCGCCGTCGGACCTCAAGCTAGTCTCTACAACTAGTTCGCCAACGCGTCGTACTCGAGACGCTCGTAGTAAGTAGAAGAAGCGGAACGAGAATAGGAGCCGCAACACAC
Strand-Sequence-269	ACATCCAACACTCTACGCCCAGAACGACTCGAACGAGTACTACCGGTTACCTACGAACCGGTCCTAGGTCGTAAGAAGCTCTCGCTACTCGGTAGTTCGCCGGCGAAGGTACTCGAGAGAGCCTCAAGAGCCTAAGCGAACGAAGGAACGGAAGAGAGACGTCGTTAAGGTTACAAGAGGAACGAACGGAAGGTCGGCGGACCTAAGACGGTAAGAAGCGTACCGCCGAAGAATAGGAGCCGCAACACAC
Strand-Sequence-270	ACATCCAACACTCTACGCCCTTACCTAGTACGTAGAACGGTCGGACTAACTAGACTCGGACTACCTAAGGCTAAGTCTAACCTCCTAGCGGCGCCGTTAGTACGACTACGAGTAACCTAACTCTCGGTACTACCAAGTTAGAACGCAACGTCAACGCTCTACGAACGTAAGCCAACGGATCGAGGAGTCGGAAGTTCCTCTACCGGACCGAAGTCTAAGAGTACTCGACGGAATAGGAGCCGCAACACAC
Strand-Sequence-271	ACATCCAACACTCTACGCCCTAGAGCAACTAGGAAGAGTAGAAGAGTACCGCGAGGAACGAACAAGAGTTCGCTCGGTCGAAGGAAGGCTAGTTCAACGCTAGAGAGTACCTACCTAGTCTCTCGAAGTACTAACAAGGACGCGCCAAGACTCGAAGACAACTCGGAAGTAGACGCCTCGAAGGAGAAGCGTTACCTCTAGACGGAGACGTCGCCGCCGCTCGGTAGTAAGAATAGGAGCCGCAACACAC
Strand-Sequence-272	ACATCCAACACTCTACGCCCTAAGTCAAGTAAGCTCGAACGAGAAGTCTACCTAGGTAAGCTCAAGAACGAACGACGTCGAGCGAACTAACCGTTACCAAGTAAGACGTCGTCTAACTAGAACCTCTAACCTCGAGGCGGTACGGTTAGAGCGCTAAGAGTCGGTAGACGGAAGAACAAGCTCAACTACTCGAACCTCGCAACGGTAAGACGAAGAGCGGATCGAGTAACGAATAGGAGCCGCAACACAC
Strand-Sequence-273	ACATCCAACACTCTACGCCCACGACTCGAACGAGTACGAACTAAGGAACGTTCGGTTACTACGAAGCGACCTCGAGGAGCGGTCTCCTACCTAACGTCAACTAACGCTAAGCCTCGTTAGACCTACTCCTCTAGAGGTACGTCAACTACAACAACGTCGCCAACGCGAACGTCGCGACCGCGTACGGACAAGGCGGTAAGACCAAGACTAGACCTCAAGACAACCTCTAGGAATAGGAGCCGCAACACAC
Strand-Sequence-274	ACATCCAACACTCTACGCCCTACGGTACGTAGAACTACAAGACGACGAGGTACGCTAGTCGGTTCAAGACTCTACGAAGCGGTTACGCCTCGTAAGCTCGAACGACGAACAAGAAGAGTAGTAAGTCGAGCTAACTCTAAGTCGCTAGCGGTAGTAAGACTAGTCTCGGTTACCTCCAAGTCTAGTAAGCTAGTACTCGCGGTTAAGCGAGACTAGAAGACCTCCTAACCGAATAGGAGCCGCAACACAC
Strand-Sequence-275	ACATCCAACACTCTACGCCCAGCAACTAGGAAGAGAGTCTAAGCGGCCTAACGACTCCTAGCCTAAGCGTCCTCGCTCGAACGAACCTAAGGTAGTTCTAGTACAAGAGGTAAGAGAACGCGACGAAGTACAACTAAGGCTAGTTCTAAGCGTCGAGCAACCTAGAAGTCGCGTTCGCGTTAAGAAGAACGTTCTAACTAAGCTAAGACAAGTTCAACGCGAAGACGAAGGAATAGGAGCCGCAACACAC
Strand-Sequence-276	ACATCCAACACTCTACGCCCAGGAAGTAAGCTCGAGAGAAGAGATCGTAGACTAGTTAACCTCTACTCAACTCGTTACTCCTCGAACGCTAGTAACCTAACGCTACGTTCGCCTAAGGTCTACGCTAAGCTAACGAAGGTAAGTACGCTAGCTAACTAGACTAGAAGAAGAGAACGGAAGAGACGACGACGCAAGGTCTAACTCGCTAGACCGAAGGTAGGTAGTAGAAGGAATAGGAGCCGCAACACAC
Strand-Sequence-277	ACATCCAACACTCTACGCCCACTCGAACGAGTACGAGGAGGTTACTACGACTAGAGTAACTCGCTCGCAAGTAAGCTCGAGAGTTAAGACTCGCCGCGTACTACGGAAGCTAGAAGAACAAGACGAGAGAGTAGGAAGGCAAGTACGCCGCCTACGGCGCCGTACTAGACCTCAAGACCGTCTACTAGAGCGCGAGGTAGGAACGCGTCGGAAGGAAGAGGAGGAGGTAGGAATAGGAGCCGCAACACAC
Strand-Sequence-278	ACATCCAACACTCTACGCCCAACTAGGAAGAGAGTAGTAGACGCTAGACGAGTAGCAAGAGGTCGTAACTAAGCTAACTCGGTCTCTAACCTCCTACGAGTAGGAGCCTCTACAACGAACAACTAAGGTAGAGCGGACGCCTCGGAAGACAACGACGCGCCGGCGCTCTCGGCGGTAACGAAGAAGAGACGACGTCGAACCTAGAACGAGAACGAAGGAACGCTAGCGGTGAATAGGAGCCGCAACACAC
Strand-Sequence-279	ACATCCAACACTCTACGCCCAAGTAAGCTCGAGAGAACCTCGAACTCGTCGCCGGCGCTCTAACGTAAGGCTACTAACTACCTAACAACGGTAGTTACTAGTCGACTACTAGGAGCGCGAACGGTAAGAAGACCTCGAGACTCGCCGTTCAAGCCGTTCCTACTCTCTACAAGTACGAAGGTTAGTCGTAAGGAAGACAAGAGAGACCTAACGGCGCTAGACTACCTAGCGAATAGGAGCCGCAACACAC
Strand-Sequence-280	ACATCCAACACTCTACGCCCACGTAGAACTACGCTCGACTAAGTAGCGCCGCGTAAGAACTAGAGTTAACCGCCGTAAGACTACTACGCGCTAAGAAGACCGGAAGTTAGAACTCGTCGACTCAAGAGAGCCTCGCTCGACGCTAGTCGAACTACTCGAGAGACGCCGGCCTAAGGTTACCTCTCGCTAGAGACAAGAGTTAAGCGAGTTAGGAACGAAGTTAAGACTAAGAATAGGAGCCGCAACACAC
Strand-Sequence-281	ACATCCAACACTCTACGCCCTAGGAAGAGAGTAGTAGACGCAACTCGTCGAGAAGCGGCTAGTCGTACGGTAAGACTAACGGTCGGCGGTAGAGGTCGAGAACTCTCGCCGTCTACAAGTTCGAAGAACTCCTACGAAGAAGATCGAGTTAACTCGGACAACCTCGCAACTAGGAAGGCGGACTCGCGAGAGACGGCAAGACTCGAACGTACGAACCTCGAGAGTTAGAGGAATAGGAGCCGCAACACAC
Strand-Sequence-282	ACATCCAACACTCTACGCCCTAAGCTCGAGAGAACCTCGCGACCGTCTAACGACGCGTCCTACCTCGAAGTCTCCTACTACGCGAACTCGCGTAAGGATCGTTCGAACTACGCAAGGAACGACTCGTCTAACAACTAAGTACCGTCAACGGTAGCGCTAAGAGAAGTACCGGAGAAGCCGGCGGTAGCTAAGAAGCGACCAACCTACTCGGCTAACTAACCGGAAGCTAAGAATAGGAGCCGCAACACAC
Strand-Sequence-283	ACATCCAACACTCTACGCCCACGAGTACGAGGAAGTTAGACCTCGGCGCCGCCTAGGCCTCGAAGACCGCTACTAGAAGTTAAGACGCCTAGTAGAGAACCAACTAGAAGAGTAGTAGGTAACGCGAACCTAGTTCGTTCTAGTTCTAACTACCTCCTAAGAGGTACGCCAACAAGTCGACTCGGAGTTCGGAAGAAGAAGCCGAAGCGTAAGCGTTCCTAAGTACCTAGGAATAGGAGCCGCAACACAC
Strand-Sequence-284	ACATCCAACACTCTACGCCCTAGAACTACGCTCGACCTAAGTTACCTCTCGAACTCTACCTACAAGGCTAGAGTCGGTTAAGCGGCGAAGGTTACGCTCTAGAACGCGGACAAGAACGCGGTCGGTAGAGCAACTAAGGTTAGAAGTTCTAGAGCGAACGCAAGAACAAGTCGTACTAACAAGGTAGTACCTAACGACTAACTAGCGCCGGTTAGAGAAGTAGTTCGGAAGAATAGGAGCCGCAACACAC
Strand-Sequence-285	ACATCCAACACTCTACGCCCGAAGAGAGTAGTAGAAGTCTCGGCGCGTTCGCGTTCGCGTACGGACTCTCGAGCGAAGAAGGAAGCAAGAGACAACCTACCGCCTAACGCGGTACCTCGTTCAACTAAGGCGCTAACCTAGAAGAGGAAGCTCTACGAGAGGAAGCCTACGCTACTAGAAGAGAGACCGCTCGATCGTAGAGCAACTAGAGAACGAGGACTCGAGAAGGAGAATAGGAGCCGCAACACAC
Strand-Sequence-286	ACATCCAACACTCTACGCCCACTCGAGAGAACCTCAAGTCGAGAACTAGTACGACTAGGCGGAACCTAGAGTAGTAGACGACCGTCTACTAGTTAAGCGCGTTAAGGTCGTTCGCTACTCGAAGTTAGGAAGCTAGAGAGACTAAGTTCGGCTAAGCGAGCTAGAGCTAGTTAACCTAACTAACTCCTACTAGGAGGAACGCTCGATCGAAGTCGTCGTACTAGAGAACCGAATAGGAGCCGCAACACAC
Strand-Sequence-287	ACATCCAACACTCTACGCCCAGTACGAGGAAGTTAAGGACGTTACAAGGAAGACCTCGATCGTCGAGTAGAACCGCCGGACTCGGAACTAAGAACGGCTCGAGAACTAGTAAGAAGTAACGAAGGACGTACCTAACTAACCTCGCGTCGACCGAAGCTACCGCCTCGGAACGCGTCTAAGAGAACGAAGTCTCGTAAGGACCTACGTACGCTCGTACCGCGTAACCTCGGGAATAGGAGCCGCAACACAC
Strand-Sequence-288	ACATCCAACACTCTACGCCCAACTACGCTCGACCTACTAAGAGCGCTAGGTAGAGAAGCGGCGGAGACAACGAACTCGGTTAGAGCAAGTTCAAGAGCCTAGAGAACGCCGGACTCGGATCGAGAACGAGACAAGGTTACTCGTAAGCTCGGTCGTCGAAGACCAACTCGAGGACTCAAGACCTCGGAGAGAGCCTAACCGTAACGAGGACCAAGTACGAAGAAGACGCTGAATAGGAGCCGCAACACAC
Strand-Sequence-289	ACATCCAACACTCTACGCCCAAGAGTAGTAGAAGTAGTTCGAGGTACGCTAACTAAGAGTAACAAGCTCAACTACCTACTCAACAACCTCGGTAGTAACGAAGGCGGAGCGGTTAAGGACTACGCTACTCGACCGGAAGCTACTAGTTAGAGAGTTCGACGAGCGGTAGTCTCGTCGCGAAGAGCTAACAAGCCTACTAGTTCGAACGAGAAGGCTAAGGAGAAGGAACTGAATAGGAGCCGCAACACAC
Strand-Sequence-290	ACATCCAACACTCTACGCCCTCGAAGAACCTCAAGAACGCGACTCTAGAGAGAAGGTAAGCGTACGCGAGATCGAAGTAAGTCGCCTAGACTAGGAAGTAGACGTAGTAAGAGAGAACGAACAACTACGCGACGAGCAACGAACCTCTAAGTTACTAAGTCTAGAGACGGTAACAAGGAACGTACGCCAACTAGTCGTCGAGTCGGACGTAAGCGTCGAGAAGAAGTCGGGAATAGGAGCCGCAACACAC
Strand-Sequence-291	ACATCCAACACTCTACGCCCACGAGGAAGTTAAGGAACTACGGTAGGTTAGACGGAGAGAGTAAGTAACCTACTAACTCGTACTAGAGGAAGAGCTAAGGCGCGTCGTAGAGAACTCGGAGGCGGACCGAAGCGAACTAGAGTAGTTACTAAGACAACGTCGCTCAAGGTTCGAGCGGAAGACTCGGACCTAAGGCTCGGTAACGCAACGGACTAGAACCTACCAACGCCGAATAGGAGCCGCAACACAC
Strand-Sequence-292	ACATCCAACACTCTACGCCCTACGCTCGACCTACTAAGAGCAACCTACGACTACGCTCGAGTCGGTTAGAGAGCGGAAGAACGAGCCTCGCCTCGAGTCTAGACCTAAGGACCGCCAAGAGGAGTTAAGAAGCTCTAAGGACGACCGTAAGTACCAACGGCCTAACGTACTAGTCGTACAACGGTCGGACTCCTAACGCGTTACAAGAGAGAGACGGAGAGAGTCTCTACGAATAGGAGCCGCAACACAC
Strand-Sequence-293	ACATCCAACACTCTACGCCCAGTAGTAGAAGTAGTTCGTTAACCGCCGCCGCGTCGAAGAAGAGATCGGCTCAACCTACTCAACCTACGAGCGCGTTCTAAGCTACGACTCAAGAGTTCGGAACGAGTTAACGCGCCGTCTAAGCTACCAACGCTACTAGCAAGAGGACCGTAACTAGGTTAAGGAGTACTACTCGGAGTAGCGTCAACGGTAGTAGTACGAGCGGCGGAGAATAGGAGCCGCAACACAC
Strand-Sequence-294	ACATCCAACACTCTACGCCCAAGAACCTCAAGAACGGAGACCTCGTCTAACAAGACCTCGCGAGGTTACGAGAAGCCGAAGAACTACTAACGTACGCCAAGAGAAGCGGCGGCGGACCTAAGTCGTAGTTAACCAAGTTCTAAGACTACCTACAACCTACCAAGACGAGGTAGACCTAACGAAGCGAAGCTAGTTACAACAAGGAAGGTAACTAACTCTAGAGCGTCAAGGAATAGGAGCCGCAACACAC
Strand-Sequence-295	ACATCCAACACTCTACGCCCAGGAAGTTAAGGAACCTAGAGTTAACGAAGAACGGCAAGTTCGCCGTTAGCGGTAGTCTCGCGAGTAGTCGGACTAGGTTCCTAACGTACGAACTCGTCTAACTAACCGGACGCGCCGTACGACGCCTCGCCTACTCGTAGACGTACCGGAACGGAAGTACGTCGTAGACCGCCGGCCTCTAGAAGGACGGCCTCAACAAGTTCTACGAAGAATAGGAGCCGCAACACAC
Strand-Sequence-296	ACATCCAACACTCTACGCCCACTCGACCTACTAAGTACTCGTACGGTAGTAGGACGAGGAAGAGACTAGAGAACGCTCGGCGGAGTTCGAGTAGCCTCGGACCTACGTACCTAAGAGACAACGGTACTACGAGAACCTACGCGACGTACAAGACTCGACAAGAAGGCGGAGAAGGTAACGCTCGCGAAGAGAAGAGTCTCCTCGCTACCGCTCCTCGGTTCTAGTTCTAGGAATAGGAGCCGCAACACAC
Strand-Sequence-297	ACATCCAACACTCTACGCCCAGTAGAAGTAGTTCGAGTAGAGGTACTAGTACCAAGTAGTAGTCGAACGCTCGAGAGACGAGCGAAGACGGTAGACCTAGGACTAACGGTTCGACCAAGGAACAAGGAAGCGGCTAGACTAGACAACGAAGCGCCGTACTCTCGACCTACGGTCGGAGGAGACAACAACTCGCTCGGCGGCGTTACGGTAGCTAAGGAAGCCGTCTCGCTGAATAGGAGCCGCAACACAC
Strand-Sequence-298	ACATCCAACACTCTACGCCCAACCTCAAGAACGGAGACTCGACCGCGTAAGCCGTTAGGACGACCGAAGAGAGTTCGTAACAACAACCTACGACGACTCGAAGTCGGTTCTAGAGTTCGTCGAGGAGCGAAGGCGGACCTCGAAGAGAAGGCTACGGTTACGCGAAGAGCTCGACTACTAACGTCGAACGACTCTAAGAAGCGTTCAAGTTAAGGTAACCTCGAACGAGGGAATAGGAGCCGCAACACAC
Strand-Sequence-299	ACATCCAACACTCTACGCCCAAGTTAAGGAACCTAGACGCGGAAGTCCTAAGTTCGTACGGACAAGGCCTAAGACGCTAGAAGTTAACGAAGTTCCTCGGCTAGAGCGGTTACGGTAGAGACTACGGTCTAACTCTCGCCTAACGCTAGTAGACTCGGTACGCGACGACTCGCGTCTACTACAAGAGGTAGAGGAACTAACTCGAAGGTTCGAACGCCGGCAACAACGGTGAATAGGAGCCGCAACACAC
Strand-Sequence-300	ACATCCAACACTCTACGCCCTCGTACGCTAAGTACAACTAGACTCAACGATCGAGGTTCGGCGGAACTCCTAGTTAAGACGCCGTAACCGTTCGGAACTACTACGCGAGTTAAGCTACCGGTTAAGGCGAACAACGAAGCAAGTCGACGAAGTTAAGGCGGAAGAACTAAGTCAAGACGAGCCTCGTCGCCGTCCTAAGGAGATCGAGGAGACCTCGGTCGAGGACTCGAGAATAGGAGCCGCAACACAC
Strand-Sequence-301	ACATCCAACACTCTACGCCCAGAAGTAGTTCGAGTAAGGAAGGTTCGTAAGTCTCGTTCTAGTTCGGTCGGAGGACCGGTAACGGAACCAAGTTAACGTTAAGTTAGACGAAGGAACGACTAACGTTCGGCCTAACTACTCGAAGCCTCGGAAGTAAGTACGCTCGCTACGCTCGACCTCTAACCTAAGGCTCGTTCGCGTAACTCGGCGGCTAACCTCGCAAGAGTACCGAATAGGAGCCGCAACACAC
Strand-Sequence-302	ACATCCAACACTCTACGCCCTTCAAGAACGGAGACTCGACCAACTCGTAAGTCTACGCTCTCTACGTCCTAAGGTACCTCGCCTAACAAGCTAGCGGTTAGAAGAACAACGCCTAAGAGAGGTAACGCTAACTAGAACTCAAGTTAACGAGTACTAAGACCTCGTCGTTAACGACGACGTAGACTAGAACCGCCGCCGAAGCTACCGTCGTCGGAGAGGAAGGACTCGGCGAATAGGAGCCGCAACACAC
Strand-Sequence-303	ACATCCAACACTCTACGCCCTTAAGGAACCTAGACGCGACGACCTACGTCGGAAGCGCGTACCTCTAACCTCGCTAGTTAAGCGGTAGAAGTAACAAGAGACAACTCCTAAGTCTCTAAGGAACTACCTACGCCAAGTTAAGCGCGACGTAACGCAACAACAAGTCGAAGTACGCTAGGACTCAAGCGACTCCTCTAGCCGAAGCGTACGGCAACGTCAACGCGTTCTAAGAATAGGAGCCGCAACACAC
Strand-Sequence-304	ACATCCAACACTCTACGCCCTACGCTAAGTACAACTACAACCTCGCCGAAGGTAAGTTAAGTACCGGCGGTACTCGATCGAGTTACTAGTCGTTCCTAACCGAACGACCTAAGAAGAAGACCTAGACTACTAGGTAACTCGCCGCTACCAAGACTCTAAGGTAGTCGAGCGAAGCGAGACTAACGACGTTCAAGACTCAAGAGTAAGAGTTACAAGTCGGATCGAGATCGGAATAGGAGCCGCAACACAC
Strand-Sequence-305	ACATCCAACACTCTACGCCCAGTAGTTCGAGTAAGAGTTAGTAACTACAACGAAGACTAAGCAACGCGACCAACGGATCGAGAGAAGGTAGGACTCGACCTCGGAGGACCGCGAACTAGTACGAACTCGAAGGAACTAGCGCGAGGAACTCGTAACTAGAGACGTTCAACAAGGAACCTAGAAGCGCTAACAAGAACGGAAGTAGCGGCCTAACCGTCGTCGGTTAGAAGGAATAGGAGCCGCAACACAC
Strand-Sequence-306	ACATCCAACACTCTACGCCCAAGAACGGAGACTCGAAGAGATCGTTAACCGGACCTAGCGGTAGGCGGTAAGAGACGAAGTAGAACTAGGAAGCGTACCTCTAACGAAGACGCGCTACCTCGACGAGAGAAGTCTACGTCGTCGGTAACCTCAAGAACGCGGAAGAGAAGTTCGAAGCCGGAGACGGAAGACCTACCAACCTAAGGTTCGGTTAGGAACTAACGGAGTTCGAATAGGAGCCGCAACACAC
Strand-Sequence-307	ACATCCAACACTCTACGCCCAGGAACCTAGACGCGAGGTTAACGAGAAGTCTACCTAGGTTAACCAACCTCTACCTAAGAACGAACAAGACTCCTCGCCTCGCGAGGAACCGGTAAGACTAACTAGAACTACCTACGAGCCTACAAGCTAGACCTCTAAGGAACGCCTAAGAACTCGGTTCGTTCTAGTTAACCGGAGAACTAAGCGGAGCCTAGGAAGCGTACGCGAGTGAATAGGAGCCGCAACACAC
Strand-Sequence-308	ACATCCAACACTCTACGCCCACTAAGTACAACTACGCCTACTACTAGAGCCTCGAAGCGTTCGCCGGCGCTCTCAACAACAAGAGAGAGAGGTAAGAAGACCTACTAACGTAAGGTAGGAGAGACGAAGGACAAGCTAGCAACCTAAGGAACGCGAACGGTTACCTCGGTAGACCTAACGAAGACAACGTCTACTAGTAACCTAGAACCGTCGTCAACGGCAAGTAACGCGAATAGGAGCCGCAACACAC
Strand-Sequence-309	ACATCCAACACTCTACGCCCAGTTCGAGTAAGAGTTAAGGCGGTTCGTTCCTCGGCTACTCGAGAGAGAGCGCCGCGACGTAAGACGCCGCGAACAACGGAACTACCAAGACCGCCAAGTAGTTAACGTTCTCGTAGAAGAGGTTCAACAACGTCGGAAGAACTCTCAAGGAAGCCGGCCTCGCTCTCGTCGGCTCGAAGAGAACCGAAGGTACTAGGCGGTAGAACTAAGAATAGGAGCCGCAACACAC
Strand-Sequence-310	ACATCCAACACTCTACGCCCAACGGAGACTCGAAGAGACTCGCCAAGTAGAGCGGCTACGAACAACTCCTAACCGTCGCGTAGTAAGAGAACGGACTCGAAGTCGGAAGAGAGAACGTCGTCGGTCTAACGAACAAGTTAGAACAAGCGACTAGCTCGAGCGAAGGAACCTCGAAGTAGTTAACGTAGACTAGTACTACTCAAGGAACCGCCGGCGGCTACTAGTTCTACGAATAGGAGCCGCAACACAC
Strand-Sequence-311	ACATCCAACACTCTACGCCCAACCTAGACGCGAGGTTCCTAGAACGCGCGTTCCTAAGACTACTCGGCCTAGACGCCGAAGAAGTCCTAGAAGCGAGGAGTTAAGGCGTCAAGACCAACGCCGGCGCGTAAGGCTCTCCTCGAAGTCGGTACAAGTTACTAACTAGACTAGAGACCGTTCTCGGCTAACAACAACGAGACGCTACCGTTAGTAGAACGAGGAAGTTCGGTGAATAGGAGCCGCAACACAC
Strand-Sequence-312	ACATCCAACACTCTACGCCCTCGAGTAAGAGTTAACTCGAAGGTACCAAGTACGGTTAAGGTAGTACCTACGTCCTCGTCGAAGGAACGAGTCTCCTAACGAGCTAACTCCTAACTCCTACGTTAAGGTCGACTACTAGACCTAGCCTACGACTACGCGAACAAGAGAACTACGCCTAGACGTAAGAAGCCGCCAAGAGTTAGAGGACTCGGTTCTAACCTCCTCCTAACGAATAGGAGCCGCAACACAC
Strand-Sequence-313	ACATCCAACACTCTACGCCCAGAGACTCGAAGAGACTCGCCAACGCGTTAACCAACGGTCTCGCCGGCAAGTTAAGGTTACGACGCTAAGAGAAGACTAAGACCTAGAGAACTACCGCTACGACCGTAACCGCTCAAGCCGCGAACCTCTAAGCCGGATCGTTACTCGCTCGCAAGAGTCTCCTCTACGGTACGTCGAGAAGCGAACTAGAGAGCGAACGTACCGTAGACGAATAGGAGCCGCAACACAC
Strand-Sequence-314	ACATCCAACACTCTACGCCCTTAGACGCGAGGTTCCTAGAAGACGGCGGTAGAAGACCTAAGTCGTAACCTAGACAAGAACGATCGTAGTCGTAGTTACTCGTCGGACTCGCGAACAACGCTACTAAGTTCTAACCTCCTAACTACTAGGAACGAAGCGGTTAGAGTACCTAAGAGTTACCTCTCGCCGCTAGGAGGTAGACGACCTCGTACTACCTCGCCAAGTTCGTCGAATAGGAGCCGCAACACAC
Strand-Sequence-315	ACATCCAACACTCTACGCCCTACAACTACGCCGTACGCGGTACCGTTACTCTCAAGAGTAAGAACAAGGAAGACGCTAGTAACGCTAAGTACTAACTAAGAACGTCGTTCGGTACGAAGTAGTAAGAGAGTACGAGAAGTACGACTACGACTACGAGGCGGACGAGTACCGCGAGAACCAACGGTAGCGGACAAGGAGAAGGACTAAGAAGCGCTAACGCTCCTCCTCTAGAATAGGAGCCGCAACACAC
Strand-Sequence-316	ACATCCAACACTCTACGCCCAGTAAGAGTTAACTCTAACCTCTCGCGAGAACCGTTAGCCTAGAGAGAAGACTAAGCGGTCTAGACGGTAGCGCTCAAGGACTCGAACGACGCGCCTCGTTCGGTTAACTAAGACCTAGTTACGGTAGAAGTCGGTTCTAGAGAAGAAGTACTACCGCCGTCGAACTAGAGAGGAACGCGTCGTTAACGTAACTAAGTACCGCCTCTCGCGAATAGGAGCCGCAACACAC
Strand-Sequence-317	ACATCCAACACTCTACGCCCAACTCGAAGAGACTCGGAACCTAAGAGTTCGAACTCGGCGAAGCCAAGGAACGCAACGCCGGAAGTCGGAGTTACGTCTCGAGACGCGTCGCGTACGCGTACTCGACTCTCGGCTCGAGACTAACTAACTAAGAGACGACGACGTCGAAGTTCGTCTAAGAAGCGACGAGGACCTACTAGAGGTAGTTAACCAACTAAGCGTTCGAAGTCGAATAGGAGCCGCAACACAC
Strand-Sequence-318	ACATCCAACACTCTACGCCCAACGCGAGGTTCCTACTACAAGCGGAACTCGTCTCGACGAGAAGCGGAAGCCTAAGTTAAGGAAGAAGCGCGAACGGTAGTAACGGCGCGACTCAACAAGAAGAGAACGGTAAGGAACGGAGTAGTACTAACCTCGGTACCGTAACCAACTAAGTCAACGCGAGTCGGCGGAGACCTCTACTCGGCGTCGCTAACGCCAACAAGAGCTACGAATAGGAGCCGCAACACAC
Strand-Sequence-319	ACATCCAACACTCTACGCCCAAGAGTTAACTCTAAGAACGCGGTTACTACTAAGGTCGGTTCCTAAGGACCTAAGCCGAAGACCTACAACTCGCGGAACGCGAAGGACCTAGTACGACCAAGAACTAAGGAGAAGAACCTAGGTAGAGTTAGAACTACCTCTCGTAACTAACTAGGTAACAAGAAGTTAGGACGTAAGGCGAAGCTCGAACTCGAAGTAGGTCGAGGAGTGAATAGGAGCCGCAACACAC
Strand-Sequence-320	ACATCCAACACTCTACGCCCTCGAAGAGACTCGGAACCTAAGACGCTAGCTCGTAACTCCTAACTCGCTAGAGCAACCTAAGCCTCGTCTCGTCGTCGAAGTCGTACAAGTTAAGGCGGTACAAGTAACTAAGCGGTTAGTACTACGCGACGTACAAGAACGTCGCCGAAGGTAGTTAGTCGACTAGCTACGGTTCGACGAGGAAGAGCGCTAGCTACGTCGGAAGGAACGAATAGGAGCCGCAACACAC
Strand-Sequence-321	ACATCCAACACTCTACGCCCACGAGGTTCCTACTACAAGCGAACTCGACTCCTACCGAACGCCTACAAGCTCAAGACTAGAGCTCGACTCAAGGAGAAGTCGGTAGTTAAGCTCGAGAAGCGTTCGGAGAAGGCGCCGCTAACTAGACTAAGACTCGAACTAGCGGCTAAGAGTAACAAGGAGAGTTCGGTAAGTTACCTAGTACTACTAACGCTAAGTTAACTACGGAAGAATAGGAGCCGCAACACAC
Strand-Sequence-322	ACATCCAACACTCTACGCCCTACGCCGTACGCTAGACGTACAACTAGAACTCGAGACGCTACTAAGCGACCGTCTAGTTACTAACCGGAACTCGCGAAGAGAGTAGCGGTCGGTACTAGGAACTAAGCGCTAGTAAGAACTACTCGACTAGTAGTCTAAGGAGCGCTAACTCGGAAGACGGCCTAACTACTCCTCGGTACAAGGAAGAGACCTACCTCGTCAACGGCGGTGAATAGGAGCCGCAACACAC
Strand-Sequence-323	ACATCCAACACTCTACGCCCAGTTAACTCTAAGAACGCGCTACCGCTACCGGCGTCCTCGCCTAAGTCGCTAAGAGACTCCTAAGGAGCGGAACCAAGTCGACTCAAGCGTACTACGGATCGTTCTCGAGGCGGACGACTCCTCAAGTCGGTCGGAGGTCGAGTTCGAACTCTAGTCGGAGACAAGACCTCGCTCTAAGTAACTACGTCGCCTAGTAAGCTCCTACTACGGAATAGGAGCCGCAACACAC
Strand-Sequence-324	ACATCCAACACTCTACGCCCAAGAGACTCGGAACCGAAGCTCTCGGAACGACTAGGTAGTTCTAACAAGAGAACTCGAGAGAGTCGTAGTTAGAACGCGAACCTAGTAGTAAGGAACTCAAGAACGGTAGACCTCCTCTAAGTACCGTCGCTAGTTACGGCGGCGCGTAGCTAGAAGCCGTAACCGCTCTCGCGGAAGAGTCGACTAGAGAAGTAGAAGTCGGAACGTAAGAATAGGAGCCGCAACACAC
Strand-Sequence-325	ACATCCAACACTCTACGCCCAGGTTCCTACTACAAGCTAGCCTAAGGCGGAGCTCGAGTAGGTAAGGAACTCTCGGTCGGTCGACTAAGAGTAGGTTCGGAGACGGTCGGACCGCGTTAACCTCGTCGAGGCGGAGAGAGTTACGCGTCTAGTAACTCGCCTCGTAGGAACTCTAGGAAGACTCGTAAGGTTAGTTAAGGAAGACGAGACAAGCGTTAGTCAAGACCTAGGAATAGGAGCCGCAACACAC
Strand-Sequence-326	ACATCCAACACTCTACGCCCACCGTACGCTAGACGAGCTCGTACAACTACGCTACCAAGAACGGCGCGTTACCTCTCCTCCTAAGGACGACTACTCGGAGCAACCTCCTCGGTACGTAAGCTACTCTAACCTAACTCCTCTACGCTCGGTAGTTAGAGTTACCTCAAGACGGTAGAACTCGGAAGAACGGAACGTCGTAAGAAGACTCGACGTAACTCTAAGGTCGGACCGAATAGGAGCCGCAACACAC
Strand-Sequence-327	ACATCCAACACTCTACGCCCTAACTCTAAGAACGCGTCGGAAGTTAGACCAACCTACAAGGAACGACGGAAGTCAAGTACGGCGGCGAACTAACTAACGGTACTCGAAGGAACGGAAGGACCTAAGAAGTCTCGTCGTTCGCTCGAAGAGAAGTCGGACTAGAGAGCGGTCTCTAGTCGAACGCCGCCTACTAACTCTAGTACTACAAGTAACCTAAGTACGAAGCTCAAGAATAGGAGCCGCAACACAC
Strand-Sequence-328	ACATCCAACACTCTACGCCCTTCCTACTACAAGCTAGTACGGAAGCCGGCGCGTCGAGTTCGAACGAACGCTAGTCGACTCGGTACGCTCTAAGTACGTAAGGAGAAGGCGCCAACAACTACGGAAGTAACTAAGTCTACTAAGTCCTAGAACTCGGTCTAAGAACTAACGAACAACTAAGTCTCGCCAACGAAGACTAGACGGAAGGAAGCGCGACTAGTAGTACCTAGGAATAGGAGCCGCAACACAC
Strand-Sequence-329	ACATCCAACACTCTACGCCCTTCTAAGAACGCGTCAACCTAAGACGCTAGAAGTAAGAGGAAGGTAACGGCGCTAGCCTAACGAGTCGGAGCTCGAACGAAGAACCTACCTACGCTCCTAACGAACGGTACTCGTTCTAGAGTTACGCGTACTAAGCTAGGACGACGACGAACGAACAAGCGAGCTCGGACCTCTCGTACGAACTACTCCTAACTACCTAACGAGCGAGAGAATAGGAGCCGCAACACAC
Strand-Sequence-330	ACATCCAACACTCTACGCCCTTCGGAACCGAAGCTAAGAACTAAGACGGTAAGACCGGTTACAACTAAGTCTAGGAACAAGGTCTCTCGACCTACCTCAAGTAGAGTAGAAGAGAAGGACGCGCTCTCGTCTAGAGCAAGAGCAAGTTAGAACAAGAGAGGTTCGCGAGGTTCCTCCTACAAGCTACTCGGTTCCTCGAACAAGGAAGCGTCGGCGGCGGTACCGCCTAAGAATAGGAGCCGCAACACAC
Strand-Sequence-331	ACATCCAACACTCTACGCCCTTACTACAAGCTAGTAGGTAGTCGGAAGTCGTCGCCGCGAGACAACAAGCTACCGTTCGGCGGACTCTCCTCAACTACGAACTAAGTCTCGGTTCGACCGCCGCGAGGAGCTAACCTAGGCGGTAACAACCTAGAAGGAGTTCGACTAGTAGACAAGACGCTCGATCGAAGAGGTAAGGTTAACAAGGACTCTAGTCGTTAAGGTAGAGCGAATAGGAGCCGCAACACAC
Strand-Sequence-332	ACATCCAACACTCTACGCCCTAGTAGACGAGCAACGCCGCGTCGTCGTCGAGGAGACTAAGCAACTAAGTCGTCGCTCCTAGACTCGCTCCTCCTACTAGGAGCGCCGCGTAAGCGAACAAGTACGCTAACTAGTCGACGAGCAAGTAGTCGAGCGTCGCCGTAGAGTAAGCGTAAGGACCTAGTCTCTCGAAGTCGAGTTAGTTCCTCAAGGAAGGCGGAACTAGACCTGAATAGGAGCCGCAACACAC
Strand-Sequence-333	ACATCCAACACTCTACGCCCTAAGAACGCGTCAACGAAGACTCGACTAACGCCTCGTCGAGTCGGACGAGGCGGTTAAGAAGGACCGCCTACAACAACAAGTAGAACGCTCGGAGCGCTCTAGACGGTAACTAACTCTAGTTCGGTACGTAGGAACGAAGACTACGAGAGTCGACTACGAACGGTTAGCTCGGTCTAACGAGCGGCAACTACGCGAGTCTCGTCCTAAGCGAATAGGAGCCGCAACACAC
Strand-Sequence-334	ACATCCAACACTCTACGCCCAGAACCGAAGCTAAGACTCCTCGACTAAGTTACGCCTACCTAGACGCGAACTAGGAACGCCTCGTCGTCTAAGCTACCGCTCAAGAGTTAACGAGTAGTCTAGACTAAGCTCGATCGTCGTAAGTCAACTAACGCGGCAAGAGCGCGTAAGGAACCGAAGGTTAACGAACCGAAGAGTACAACGGCGCTACTCCTACTAGAAGTTAGTACGAATAGGAGCCGCAACACAC
Strand-Sequence-335	ACATCCAACACTCTACGCCCTTACAAGCTAGTAGGAGCGGTACGTTCTACGCCGGCGCCGCTACCAAGAGAGAGACGAAGGAAGCTCTAAGTTAGAGGTTAAGCTACTAGACTACCGCTAGGAGCGAACTAAGCGAAGAAGGTAGGCGGTAAGCGTACGCTAGTAACAACGCGAGCGAAGCCAAGTAGGAAGCCGTCCTAGAAGAGTAAGAAGACGGCAACTACGGCAAGGAATAGGAGCCGCAACACAC
Strand-Sequence-336	ACATCCAACACTCTACGCCCTAGACGAGCAACGCCTCGTACGGCGCGAGCTCGAAGAACTAGAACGTCGCGTCGACCTAGAGTAGACGCCTCGCTCGGAAGACGAGCTAAGCCTAGAAGAACGCGTAGTAACTCGCTCGAGGACGCAAGACGACCGCTAACCTCTAAGGCAAGAGCTAGTAAGTAAGTTCGTTCTAAGCTAACGCTCGAACGAAGACCGAACCTACTACCGAATAGGAGCCGCAACACAC
Strand-Sequence-337	ACATCCAACACTCTACGCCCACCGAAGCTAAGACTCTAACGTAAGAGAACGAACTAAGTAGCTAGTAAGCTCAACGAAGCGTCGGACAAGACGAACAAGACCTACCTCGACCTCCTAGTAACGCGACGTAAGCTCGACCTCTCGGAGAGTTACGAAGAGACGGAACCGCTAGCGTCAAGTTAACTAGTCGGTTAGACAAGTCGTTAGAAGACGTCAACGGATCGTAGAGTGAATAGGAGCCGCAACACAC
Strand-Sequence-338	ACATCCAACACTCTACGCCCTAAGCTAGTAGGAGCTACTAGACGAGAAGAAGGTAAGGTTCGTTCTCGAACGAAGAGTTACGCAACTAGAAGTTCAACTAAGGAAGAAGTTCGACTACGAACGGCGGCGGCTCGTTAGACGCGTAAGACGCGTACCTCCTCCTACGAAGGTCGACGAGTAGCGCGAGGTTCCTCGCTCTAACCGAACTCTAACCTCGCGAAGACAACGAAGAATAGGAGCCGCAACACAC
Strand-Sequence-339	ACATCCAACACTCTACGCCCTAGAGGAACGAAGGAAGGTAGAGGACCGGTACGAGGAGCAACGGCGGACCTCCTCGCGGAACCAACGGCTACTAGTTACTACTAACGTACGAAGAAGAACAAGCCGGCAAGACGTAACGCAAGAGATCGAGCCTAAGGTTCGAAGAGGAACTCAACGCCAACCTCGCTAAGTACGCGTAGTAGTCGAGGTAGTAGTAGGAACAACAACCTGAATAGGAGCCGCAACACAC
Strand-Sequence-340	ACATCCAACACTCTACGCCCGAAGCTAAGACTCTAACCGCGAAGTAGAGACTCGCGTAACCTCGGTTAACTCGAACGTTCTACGTCGTCGGTAGGCGGTACGCGTTACGAACTCGGAAGACCGTAACCAAGTCGTACTAGACCGTACCTCGAACGTAGACGACTCCTACTAGCTAGAGTACGACTACTCGGTCGTAAGGTTAGAAGAACGGCGGAAGCAACTACAACGTCGAATAGGAGCCGCAACACAC
Strand-Sequence-341	ACATCCAACACTCTACGCCCACTAGTAGGAGCTACGAAGACGGAACGGAAGACGAAGAACTAACGAACCTCGTCCTACTACGCTCGAGGACCGCTCCTAGCAAGTACGAAGCTAACGGCTACGGCGAAGACTAGAACGCGACCGCGAGTAGTTAGACTAACTCGTTAAGACCTCAAGACAACCTCAACGCCTAGGAAGGTAGAACGTAACGACCTACGTTAAGGAGATCGGAATAGGAGCCGCAACACAC
Strand-Sequence-342	ACATCCAACACTCTACGCCCAGCAACGCCTCGAGCGCTAACCTAACCAACGCGACCTAGGAACAAGGCTAACGCGGAACGTAACGCTCGTACTAAGACGGTTCGAGCTACGCTAACGTTCGACTAAGTCGGAAGACTACCGCTCTAGAGTAAGGTAGCGCCTAGTAAGCTACCGTAACCGTCTAACGAAGCGCGAGGTCGTAGGAACTACAACCTCTCTAGAGGACCGGAGAATAGGAGCCGCAACACAC
Strand-Sequence-343	ACATCCAACACTCTACGCCCAGGAACGAAGGAAGGAGTTAGAGCTCGAGAACCGTCGGTAGGAGCTACGTCAACAACTACGGCTACGCGACGTAGTTAACGAGCGCTCGGAGCGAACAAGGTTAAGGCGGCTCGTTCAACCTACAACGCGGTAGGTTAACCGTAACCGTTAGAACGAAGAACTACTACGAAGAACGCGCCTAAGAGTTCGGTCTACGACTCCTCGCTAGGGAATAGGAGCCGCAACACAC
Strand-Sequence-344	ACATCCAACACTCTACGCCCACTAAGACTCTAACCAAGTAAGTCAACAAGTACAACGAAGGCAACAACAACGAACTAACTCGCGGTTAAGGCTAGACTCTAGAAGGACTCGGAACCAAGAGACTAACCTCGACTACTAAGGCTAGGTTAGAGAAGAAGTACCTAAGTACGACTAACCTAAGTAGTAGCGAACTAACGAGACAAGCTACGAGACCTAGTACCGTACTACTAGAATAGGAGCCGCAACACAC
Strand-Sequence-345	ACATCCAACACTCTACGCCCAACGCCTCGAGCGCTACGAACTAGTCGAACGCCTAACCTACTAACAACTAACGCTAGACTCCTAGACTCGCTAACTACTAAGAGAGCGAAGACGGTTACGGCGCGTTCTAAGGCGGCGCCGTCAACGGCGCTCCTCTCGAAGCGTTCGAAGAGTCGAGCGTAAGTCTCGTCCGTAGCTACTCCTAGACGAACTAAGGAGAAGAAGGTCGGGAATAGGAGCCGCAACACAC
Strand-Sequence-346	ACATCCAACACTCTACGCCCAACGAAGGAAGGAGTTACAAGGAACCTAGAGAGTAACGCTAGAAGAACCTAAGTAGGAGAACCAACGCTAGTTAGTAGTAACTACTCGTCGGACTCTAAGGCGGTAGCGGCTCGTAAGGCGGACCTACGTTCGCCGTTCTAAGGACGAAGACCTACGGTAGTAGCGTCGCGTTAACGAGCTAGAACAACTCGTAACTCGAAGCCGGCGAAGAATAGGAGCCGCAACACAC
Strand-Sequence-347	ACATCCAACACTCTACGCCCAAGACTCTAACCAAGAGTTCGACTAGAACTACCTAGTTCGCTCGGTCGTAAGCTACGTAGTTAAGTTAGAACTAACTAGAAGAACAAGAGAAGAGGAGCAAGAAGGAACGAAGTAGAGACGGCGAAGAGACCTAGTTAGACCTAAGTCGGAGGAGTTACGGTAGCGCCTCGAGAGAAGCCTAACGAAGGTAAGCTAACGGACTCGAACGAGAATAGGAGCCGCAACACAC
Strand-Sequence-348	ACATCCAACACTCTACGCCCAGGAGCTACGAACGAGACGCGAGTAGGAACGGTAACGCTCGAGAAGGCAAGAAGAGAGAACTCTCGTACGCGAAGTCGAAGTAAGCGAGCCTCCTACGAAGAACGTACGCCGCGTTAGAAGACGCTACCTACTAAGCTAGGACGACGTAACGCGCTAAGTAAGCCAACTCGACCTCGAACGGAGAAGGTACCGGACCTCGCGGTTAAGGAGAATAGGAGCCGCAACACAC
Strand-Sequence-349	ACATCCAACACTCTACGCCCACCTCGAGCGCTACGAACTAGAACCTACAAGGCGAAGCGAGTCTCCTACGCTAGGAAGGTCTCTAGTACTAGAAGTTAACTCTAACCTACGCCGCTAGGTTCGCCGCCGCGTTAAGACGCGGTACTCCTCTCGGCAACAACTACAAGTACGCCTCCGAAGGCTAGTAGTTAGAAGGAGAGGAACTCGAAGAGTTCGCCTCGTTCGCCAACGAATAGGAGCCGCAACACAC
Strand-Sequence-350	ACATCCAACACTCTACGCCCGAAGGAAGGAGTTACAAGGAAGACGGTAACGAAGCTCTACTCGTCCTAACGTAAGGACTAAGCGAACGCGGAGACAAGACCGGTTAGACGAGTACGAGCGCCGCCGGCGTCGCTCTCGGTACTACCGAAGAACGACAACAACGCCTCTAGACCTAGAGCTAAGGTTCGACTACCGGACAACGCCGTACGAAGAGCTAGAACGGAAGTTAAGAATAGGAGCCGCAACACAC
Strand-Sequence-351	ACATCCAACACTCTACGCCCACTCTAACCAAGAGTTCGAGTACCGCTCGGTCGACGACGACCTCGTAACGACTCGGACGCAACTAAGCCTAAGACGTCGCCTACAAGTAGACCGCTAGATCGGAAGAAGCGTTACGCGGTAAGAGAGAACTCTAGACGTAACGATCGAGCGGAACCTACTAACTCAAGTTCAAGAGTCGGCGGTACAACCTAGAACGCGGTTCGAACTAGGAATAGGAGCCGCAACACAC
Strand-Sequence-352	ACATCCAACACTCTACGCCCAGCTACGAACGAGACGGAGACGAACGAGAAGGTCTCGTCGGTCTACGAAGCGGTTCGAGTAACCTCTACAAGACGTAGAACCTAGACGGCTAACCTCGGAGGTTCTACCTCCTACTACGAGAGACGTTCGCGTAGTACGCCTCGACCGGCTAACAAGGCTAAGTCTACCGGTTCGGAACCTCGTTCGCTAGTAGCCTACTCTCCTCCGAAGAATAGGAGCCGCAACACAC
Strand-Sequence-353	ACATCCAACACTCTACGCCCTCGAGCGCTACGAACCTACGCAAGAGAAGCGTCGTCTCGACTAGCGGCAAGAAGAGCCTCTCGAGCGGAGACTAAGTCGGAAGGAACAACGGTCGGCGGTCGAAGACCTACTAGTAGGAACCTCAAGCGTTCGAAGAAGAAGCTCAACGCTAGTTACGAGAGAGTTAGAGCTAGAAGTCGAGAACTCGGCGGACCGTAAGGAGTAGGAGTGAATAGGAGCCGCAACACAC
Strand-Sequence-354	ACATCCAACACTCTACGCCCAGAAGGAGTTACAAGTAGGAAGTCGTCTAAGCGGAAGAAGTCTCTCGGAACGCCGTTCCTAACGGAAGAGGTCTCTAACTAGAGACCGAAGCGAACAACTACGTCTACCTCTACGCTAGTAGTACTACCAAGACGAGCGCGACGACTCAAGGCCTAGAGTAAGCGAGTAGTAACTAGAACGGTAAGAGAACTCTACCTAGGTTCTAAGACGAATAGGAGCCGCAACACAC
Strand-Sequence-355	ACATCCAACACTCTACGCCCTTAACCAAGAGTTCGTAAGCTACTCGGACGAGGTTACGCTAGAGTACGTACAAGTTAAGCCTCAACCTACCTAGGACGTAAGCTCTCGTCTAGAACGCGTTCGCGACTAGCGGATCGTACGTCTACGGTAGGAAGAGTCTCGCTCTCGCGAGTTACTACGGCGGCCTACGACAAGTCTAGACTACTCGAGAACTAAGCGCCGCGTACTAGGAATAGGAGCCGCAACACAC
Strand-Sequence-356	ACATCCAACACTCTACGCCCAGGAGTTACAAGTAGAGTAGACAACTCCTAAGGTAAGCTCGGAGTACGAGCGCGACGACTCGAACTCTCTAGTAAGGAAGGTACGGAGACGCCGTAAGCGGAACTCGACTACTCGGACAAGCTCGAACGACGAGACAACCTAGGTAAGCGTTCTAAGGAGTCGGAACTCGCTACGCTAGCTAGTTCGCGACGTTAACCGTACCTAGACTAGAATAGGAGCCGCAACACAC
Strand-Sequence-357	ACATCCAACACTCTACGCCCACCAAGAGTTCGTAAGACCTCGCGAGCGTCAAGTCGAACGGTAGTACGGAAGCGTTACTACGCGTCGCTAACCTCGGAGACGTCTCGTTCTCGAGCTAGAGGTAGACGTAGACCGTTCGCTAGTAAGCTAAGAGTAACGGTACGAGACTACCTCGGCGGAGAGACTACGGCGGAAGGTAGTAAGCGAGTACCGCTAGGTAGAAGAAGAGAGAATAGGAGCCGCAACACAC
Strand-Sequence-358	ACATCCAACACTCTACGCCCGAACGAGACGGAACGAAGTTACCTACGGAACTCCTCGGCGCCGTCGGCGCGTAGGAAGCCTAAGCTACTAGCGAACTAGAGTACAAGAGTAGCTAGACCTACGTCGGTACCAAGTAGACTAGGACGGAAGCCGCCTACTCGTTAACTACGAGCGGCTAGAGGAGCAAGAGTACTAGACCTAAGAAGTCGTCGAGCGCGTACGAAGACGGTGAATAGGAGCCGCAACACAC
Strand-Sequence-359	ACATCCAACACTCTACGCCCACTACGAACCTACCTCGAGAGTAGGAACTAAGTCTAAGACAAGTCGAACGCGCGACCGCGAGTACCTACTACCTACGACAAGCGAGTAAGACCTAACGAACTAGGAGCGGAACCGGAACTACCGTAGAGAGCTACGCGAGCGCTACGAGTCGGACCGGCGGTTAGTAGAACGCGACCTCGTCGTAGTACTCGTAGGTCGACTACCGTACTGAATAGGAGCCGCAACACAC
Strand-Sequence-360	ACATCCAACACTCTACGCCCAGTTACAAGTAGAGTACGTCGGAAGGACGCGGACAAGGCGAACAACAAGCCGCCTCGTTCCTCGTCCTCAAGACCGTAAGTACCGAACGCAACGAAGCTCGACTAAGACAACTACTACGCAACTCGGAAGAGAAGAGGAGTAGGACGACGAGAGAACTAAGTTCGAGCGCTCTAAGCTACGCTCTCGGTACTCGGTCGTACCTCGCGTCGGAATAGGAGCCGCAACACAC
Strand-Sequence-361	ACATCCAACACTCTACGCCCAAGAGTTCGTAAGACTACTAAGAGACGAACTAACTCGTCGGAGACGGAACTAGAACGAACTCGTAGTTCTAGAGAAGAAGAAGTTAAGAACTACAAGCCGAACTAAGATCGGAACGCTACGGCCTCTCGAGAAGAGGTAGACCTAGAGAGGAACAACTACGAACTCTCAAGGAAGGAAGGACCGAACTCCTCGCGAGCCTAGAAGAGAGAGAATAGGAGCCGCAACACAC
Strand-Sequence-362	ACATCCAACACTCTACGCCCTCGAACGGAACGAAGAGCGCGAGGTCGTAAGAAGCGTAGACGTCGTTAAGCTCGAGTAGTTACGCGTACGCTCCTAGGAGGAGTCGGAGTAAGTTAAGTAGGACGAGGAGTAGGTAGAACTAGAGGACCTCGAGCAACTAGGTCTAACCTACCGGCCTCGGCGCTCCTACGAACTAGAGAAGCTAGACGAAGTAACTCGGTCGGACCGTCGAATAGGAGCCGCAACACAC
Strand-Sequence-363	ACATCCAACACTCTACGCCCACGAACCTACCTCGAAGGTACGCTACGAGCAACGGTAGTACGAGACTCTACAACTACGAAGAGTAGAACAACTACTAACGACTCTACTCGAGTACTACCTACTAGACGTAAGAAGCGAGCTCGTTCGAACGCTAACTCGCCGCTCGAAGCCTCGCCTAGAGTAGTAGGCGGAGGAACGGAAGACTACTCTAACGCGCGTAGAGTTAGTTAGAATAGGAGCCGCAACACAC
Strand-Sequence-364	ACATCCAACACTCTACGCCCTACAAGTAGAGTACGACCGGTAGTTCGAGGCGGACTACCGTAACCGGAAGTAGCGCGAGAACTCGGTCGTTAGACAAGGAACTCTACGCCTAACGCGGAACTCCTAACAACAACGGCGGAACCAACGGAAGCGGAACCGGACAAGCGTCGCTAGACGCGTAGAGTAGTTACGGTTAGTTAGAGACCGAAGTACGAACTACTCGGAGCGCGGAATAGGAGCCGCAACACAC
Strand-Sequence-365	ACATCCAACACTCTACGCCCAGTTCGTAAGACTACTAACGCGCCGGAAGGTAGTTCGGCGGTACGTACGGAACCAACCTCGCTAGTAGTAGACTAAGGACGTTCGGACGCAAGTCGAGACGCTCGAAGTACGTCGAACTAACTCGACTCGGTCGGAGTCTAGAGTAACCTAGCGGCTAAGACGGAAGTAGAGTTAACGCGTTAACGAGAGAGACTAGGACTAAGTTCAAGGAATAGGAGCCGCAACACAC
Strand-Sequence-366	ACATCCAACACTCTACGCCCAACGGAACGAAGAGCGGAACGTTCGGATCGAGTTCGTTCTAGACGACCGTCAAGACTAGCGGCTAACGCGCGAGCGGCGCTACCAACGCTAACGAAGCGAGTCTCGCGTTACTCGCGACTCTCGAAGTCGTCTCGAGTTAGACTCGGAACTAAGAGACTAGTACGAGAGACTACAAGACGACCGGCGGAAGTTAGAGTCTAAGCAAGACTGAATAGGAGCCGCAACACAC
Strand-Sequence-367	ACATCCAACACTCTACGCCCAACCTACCTCGAAGGTTACGCCTAAGGACGTACTACTAGTCGAGGTAAGAGGAAGCTAGTAGTTAACCTAGACTCGCCAACGGTTAGTCGACCGTAACCTACTAGAGAACCTCGTACGCGACGAGAAGTAGCTCGAGGAGTAGCGGCAAGACCGGTTACGCGAACTCGTAACGCGCTCAACCTCCTCAACCTCAAGAAGCCTCGACGAGTGAATAGGAGCCGCAACACAC
Strand-Sequence-368	ACATCCAACACTCTACGCCCAAGTAGAGTACGACCTAGTAACCTAGGAGACAACTCAAGACTACCGGAAGCTCGAACGTCGCCTAGTTCTAGACTACCGCTAAGAAGTAAGACGTCCTCCTCTAAGGTACTCTCAAGTAAGCCTACTCGAGCGCTAACCTCGGCAACTAACGCGGCGTCTAGAGCGGACCTAGTAAGTAACCTAGAGACAAGGAACGCAAGCGCGGTCTCGAATAGGAGCCGCAACACAC
Strand-Sequence-369	ACATCCAACACTCTACGCCCTCGTAAGACTACTAACAAGGAAGTTAACGCGGACCTCGACCTCGTAGACCTCGAGAGAACGCTAGCGAAGTCGCCGTAGACAAGTTCTCGTCGAGCCTCTACGTCGGCGCTAGAGAGTTCAAGTCGACGGAAGGCGGTCTACTAACGACCGTAGACAACGCCTCGTTACGCGCGAACGGAACCTAGACGTAACTAACGTAACGCGCGTCTGAATAGGAGCCGCAACACAC
Strand-Sequence-370	ACATCCAACACTCTACGCCCAGAACGAAGAGCGGAACGTTCAACTACAAGTAGAAGAAGACCTAACGACAACTCGCTCTAGAGAAGACCGTACGATCGTAGTCGAGTTCGAACTAGTTAACGTTACTCAACGCCTAACTCGCGTTAAGAACCTCGAACGCGAGTAAGTTCGGACTACAACTAGACTAAGGAAGGAGGACCTACGCCTAACAAGGACGCGTCTAGTAGTCGGAATAGGAGCCGCAACACAC
Strand-Sequence-371	ACATCCAACACTCTACGCCCTTACCTCGAAGGTTACGCCTAGACGCTCGACTCGGTCTAGAGACTCGCCTCCTCGGTAGCGCCGTTAGGTAACTACTCTAACGCGGTCTACCTAGGAGAAGTACGTTAAGGTAAGGAGAGGAAGACGCCGCCGGAAGTCGGCGGACCTAGTAGTTACGAGAGTCGTTAAGCAACAAGAACTACGGCGCTCGGCGGTTAACGTAACTCGGTGAATAGGAGCCGCAACACAC
Strand-Sequence-372	ACATCCAACACTCTACGCCCTAGAGTACGACCTAGTAAGACGCCGGTAGCAAGTACAACGCTCGCGCGTTCGGCGGCGCCGCTCGAACTCAACTCTCGAGGTAGAACAACTAAGCTAAGTACGTCCTCGGCGGTTAACGAAGTAGGACCGCGAGGTAGACTAACGAAGCGTAAGGTACGAACGGAAGAAGCTAGAAGTTCGGTAAGTCGAAGAGTAACAACGAACGAGAAGAATAGGAGCCGCAACACAC
Strand-Sequence-373	ACATCCAACACTCTACGCCCTAAGACTACTAACAAGCGTACCTCGTCCTACTCTAAGCCTACGGTTAGTTAACTAGCGCGACCTAGACCGGAACCAACGCGTAAGAAGAACAACTACCTACTACCGCCGCGAGCTACAACAAGAAGGAACAAGCCGTCAAGAAGTAACGCGTCAACGCGAGGTACGCCAAGTTCGCCTCGTACTAACCTCCTCTAACGAAGTACAAGTAAGAATAGGAGCCGCAACACAC
Strand-Sequence-374	ACATCCAACACTCTACGCCCTACTCGAGGTTACGCGAACAAGCGAAGACCGTTCTCGCTAGGAGTAGAAGGTAAGAACAAGGTACCTCGAGAAGCAACCTCAACAAGAAGACTACCGCGAGACCTACCGCCGTAAGGAACGTCCTCAAGTAACGACGCTCGAAGAAGTCGTAAGAGTTAACTAGATCGAGTAACGGCTAGAAGTAACCTAGCGAAGGAAGACTCGGACTCGAATAGGAGCCGCAACACAC
Strand-Sequence-375	ACATCCAACACTCTACGCCCAACTACTAACAAGCGTAAGGCGGAAGTACTACGAAGTTAGAAGCTAGGTAACTCGGTAGCTACGGCCTACTACCTAGTCTCCTCGTCGTCTACGCGTTACGACCTCGATCGGAACAACGCGGCGCGAACCTCGGAACTCGCCTACGACCTACGAAGAAGAGTTAGACTCGCGTTAAGACTCGGTCGAAGAGCTCGGAACGACTCTAAGCTGAATAGGAGCCGCAACACAC
Strand-Sequence-376	ACATCCAACACTCTACGCCCAAGAGCGGAACGTAGAGAAGGTTAACGTAGTACGGTACGACGTAGAGTAGGAGGTAAGGCGGTTAGAGAGAAGTCGCTAGGACGAACTAGACCGTTCGGTAGACCGTCAACGTCAAGAGGCGGTAGACGAGGAGGTAGAGGTACCTCCTAAGTAGGAGTACGTAACGCAAGTTACCTAAGAAGACGACCGAAGCTAAGAAGTAGAAGAGCGAATAGGAGCCGCAACACAC
Strand-Sequence-377	ACATCCAACACTCTACGCCCTCGAGGTTACGCGAACTAACCTACTAGTAACAAGAAGAAGAAGGTAGCTAGAGGAGACAACTACCTAGCTACCTAACCGGACCTACCTAGACCGTCGGACAAGGAAGTCTACTACGAAGTAGAAGGTCGACGTAAGTCCTCGCGAACGGAAGTAAGACGACTAACCTCGGACTACTCAACAACTCGGAAGGAAGGTAGGTCGGATCGAGTGAATAGGAGCCGCAACACAC
Strand-Sequence-378	ACATCCAACACTCTACGCCCACGACCTAGTAAGCCTACTAAGGTAGGAGACTAACTCGAGAAGCGTTCTAGACTCGGTAGACGTCGTCGACGTAGTTCGGCTACGTCGTCTACGAAGGCGAAGCGAGGTAGAGTTAGAGTAGTTAAGCCGCCGGCAACGGCGGAGAGACCGCCGCGAAGAGCGCTCAAGCGGTCTAGTACTAGAGCGTCCGTTACTAAGACAACCTCTCTGAATAGGAGCCGCAACACAC
Strand-Sequence-379	ACATCCAACACTCTACGCCCTACTAACAAGCGTAAGGCGGAGACGCTCAAGCTAGCGAACAAGAGGAAGCGTACGGCGCGAGCGGTTACGAAGCCTAGAAGAGGACCGTTAGGAGATCGAACGAAGGTAGGAGGAGAAGCGCCGCGTCGACTAGGACGACCTCGAGTAGTAGTTAGAGTCTCAACCTACTAGACTCGAACTACGCTAGTAGACAAGCTAGTACGACGAGTGAATAGGAGCCGCAACACAC
Strand-Sequence-380	ACATCCAACACTCTACGCCCAGGTTACGCGAACTAACTAGTCTCTCGACTCGGTAGTTAGAACGAGACCTAACTACTCGGCGGTACGCGTTCGTCCTACGCGCGACGAGAAGGAAGGAAGTCGCCGTTCGGTAAGAGTTAACTCCTACCTCGGAAGCGACGGAAGTCGGAACGTTACGACGCTAAGCTAGTTAAGGTTAGAACGAAGCGGCGTTAACCAACTACTAGACGGAATAGGAGCCGCAACACAC
Strand-Sequence-381	ACATCCAACACTCTACGCCCACCTAGTAAGCCTACGGCAAGTTACGAAGCGCTAAGTACTCGTTAAGGAACGAAGAGACTAAGTCGTTCTAGAGGAAGAGCGGCTACGCTCTCCTCGGTCGGACCGCGAGAGAAGCGTTCCTACTCCTCTCGTAACTCGAACTAACTAACAACTAAGTTAAGACCGTAACTAGCTACGGAACTACTCGACTCTCGAACGCTACTCGGACCGAATAGGAGCCGCAACACAC
Strand-Sequence-382	ACATCCAACACTCTACGCCCTAACAAGCGTAAGGCGTCTCGTACGCTACTACGAACTCGAAGACCTACTACTAAGGTTACAACGGTTAACGCTAAGGCGCCGGCGCGAAGAACCTCGCCAACTAGAGTTCGTAACAAGGTAGTACTACCGCCGAAGGAGAACTAACCGGCAACGCTAGATCGAGCGGAAGAACGAGTAGAAGTAACTACAACTAACTCTAGAGCCTCGCGGAATAGGAGCCGCAACACAC
Strand-Sequence-383	ACATCCAACACTCTACGCCCTTACGCGAACTAACTAGCGGAGAAGGAAGCTACGAACCTCTACTACTCCTAGACTACGCGTAGAAGACCTCGACCAACCTAAGACTAGAGAGGACTCTCGAACGCTCGAGGAAGAGCCTCTAGAGTCTCAAGTAAGTCGGAGAAGCCGCCGCGAACGGTACGTACGAAGGTAAGTAAGCTAGGTTAGAAGAGTTAAGCTAGACCTAACGCGAATAGGAGCCGCAACACAC
Strand-Sequence-384	ACATCCAACACTCTACGCCCTAGTAAGCCTACGGCGTCTCGAAGTCGAGTTACGAAGCCGTTCGCGTCTAGAGAAGCGCGTAACAACGCCTCGCGTCGAGGCGGTTCGCCGGCTACGAACGCTAAGGAGAAGGTAACGAAGGCCTAGAGTTCTAAGTCGCCGTACAACCTCAAGCCGGAAGACTCTAGAGTAGTTCGAGAAGAACTACTACTACCTAGAACGGTTAGAGGGAATAGGAGCCGCAACACAC
Strand-Sequence-385	ACATCCAACACTCTACGCCCTAAGCGTAAGGCGTCGCTCGGAGACTAGAAGCCTACGTCTAAGGAAGGTCGACCGCGACGGAAGAGAAGTAAGGAGTCGTCCTAACTAGGACTAACTAACTAGAGTCGACGACTAGACTCAACGCTCGCCTAACGGAACGCTACGTCTCGTTCGGCAAGTAAGCGTTAGAGACCGCGGAACAACTACCTCGCTAGAACTCGTTAACTCGAGAATAGGAGCCGCAACACAC
Strand-Sequence-386	ACATCCAACACTCTACGCCCACGTAGAGAAGGACTAGCGGTTAACTCGGCTAAGAAGCTCGAAGAAGTTACGCCGGCGTCCTCGGAGAAGCCGCCGTAGAAGGCGGACAAGGCGTCGAAGGTAACTCGAGCGTCAACTACTACAAGGAACAAGGAAGCGCTAGACAAGGCGCTCGCGCCGAACGCGCGAGTTAGTAAGCTCTAAGGTCGAGAACGTTAAGGTAAGACGTAGAATAGGAGCCGCAACACAC
Strand-Sequence-387	ACATCCAACACTCTACGCCCTAGGAACTAACTAGCTCGAAGACGAGCAAGTAAGCCTCGAGGACGACGAACGGCGTCTAGTCGTAGACGTAACTCTAGAGCAAGCAAGGACCTCAACCTACCGCGACTAACGGTTAAGGTTCGACGACTAAGTTCTAAGACAAGAGCAAGTAGACCGGCTAAGAGAGGTCGACTAAGAAGACGCCGACGACCGTTCTAGAACAAGGCGCTGAATAGGAGCCGCAACACAC
Strand-Sequence-388	ACATCCAACACTCTACGCCCTAAGCCTACGGCGTCGCGTTAAGCGGCAACCTCGAAGAGTAGGAAGGACTAGACAAGTAAGCCGAACTCAACCTACTCCTCCTCCTAACTAGCCTACTCGAACGCTACGCTCTCGGTCTCCTCGTAGAGTAGAGTAGGTACTAAGACCTACTAAGGTTAACTAGAGACAACTACGCGACCTCGTCGTACGGACAAGGTAGCTAACGCTCGGAATAGGAGCCGCAACACAC
Strand-Sequence-389	ACATCCAACACTCTACGCCCTAGAGAAGGACTAGCGAAGTCCTACTACTAACGAGTTCGACCGCTCAAGCGAGGACCGTCGCTACTAACGCGGAAGCGTAGTAAGAGAACGGTAACCTACGACTCTCGTACGCTAGGACTCGCGCGTCGACGGAAGAAGTCTAAGAACAAGCTAGAAGGTACGTCGTCTCGACGAGATCGTTACTACAACGAAGAAGCGTCTAGAAGTTCGAATAGGAGCCGCAACACAC
Strand-Sequence-390	ACATCCAACACTCTACGCCCGAACTAACTAGCTCGACTAGCGGCCTAAGCGGTAGGAGCGTCTAACCTCTACGAACGAAGTACCTCAAGACTACCTAACGACTCTACTAGACTAAGTAGACCGAAGCGAGAGAAGTCGTCTAGTCGGAAGACTACGCTAGGTCGAACTCGACTCGGTACCTACGCCGCGCTCGACCTAGGACCTCGAGGTACGGTCTAGAGAGCTCGAGGGAATAGGAGCCGCAACACAC
Strand-Sequence-391	ACATCCAACACTCTACGCCCACCTACGGCGTCGCGAGCCTCGGAACGTCGTAAGCCGTACTAGAGTCGACGAGGTAAGCCGGCTAAGAAGAAGAGTTCAAGTTCTACGGTAGGTAGAGGTCGAAGAGCTACCTAAGGTAGTCGAGCGGTAAGTAACTAGAGTAGAGGTAGAAGAGGTTACTCGGCGAAGACGCGGAAGCCGCTCTACTAAGTACGTTCGGTTACAACGCGGAATAGGAGCCGCAACACAC
Strand-Sequence-392	ACATCCAACACTCTACGCCCTAAGGCGTCGCTCGCTCGTTACTACCTAACGGAAGTAACTAGAACGGAGACTACGCTAGTAACAAGAGTAACGCGTTCGCTCTCAACGTCTAGGAACAACCTCAACAAGCTCGGAGTCTAAGAAGAACCTAACTAGACGGTAGTACGACCGGCGGCGTCGGTACGTACCTAAGCGCCTAAGTCGGCGTCTAGTAGAGTCGGTAGTAGTCGGAATAGGAGCCGCAACACAC
Strand-Sequence-393	ACATCCAACACTCTACGCCCTTAACTAGCTCGACTCTACGAAGGTACGAACAACAAGGCAAGAAGTTCCTAGACGCCGCGTTCTAGTAAGGATCGTTAAGAACGAGGAGTACCGCTCCTAGACCTCGAAGGACCGTACGAACTAGTTAACCTACCAACGGAAGGACGTTACTACGCGTCGGACAAGCCGTCGCGTACCTACGAACTCCTCGGACGAGCGCTCAAGAGTAGGAATAGGAGCCGCAACACAC
Strand-Sequence-394	ACATCCAACACTCTACGCCCTACGGCGTCGCGAGCTACGAAGAGAACTACAACTACAAGAGACAAGGAAGGACCAACCTCTACGCCGGTTAGACCGAAGAGAGTAGCCTAGAGACCTAACGAACTCCTAACGTCTAGTTACAAGCGAGCGGCGAAGCGAGGTCGAAGAAGTAAGCCGCCGTAACCGGTCGGTTCCTCGGTCTCGTCAAGACGTAGTCGTTAACTAGAAGAGAATAGGAGCCGCAACACAC
Strand-Sequence-395	ACATCCAACACTCTACGCCCAGCGTCGCTCGCTCGAGCGGTAGACCTCCTCTCAACAACTAGGAAGCCGGCGCTAACTAGAGGTCGTAGAGCTACTACAAGTTACGCGCTCGGTTAACGTAAGTCTAAGCTACCTAACTAAGGAGTACGTTAACCGCTCGGTAACCTAGACGCCTCGAAGGTAGAGACGGCGCCTCCAACTAGAGTTCGTAGTCGAAGTACGCGTCGTAAGAATAGGAGCCGCAACACAC
Strand-Sequence-396	ACATCCAACACTCTACGCCCAGGACTAGCGAAGGATCGTACTAAGGAACGAAGTAGGAAGGTACCGTAACGAAGAGGTACCTCTCGTACAAGACCAAGAGTAGAGAGTTCGGTAGGACCTCGACTCGGAACCGGAAGAGTTAACGCCTCTAGTAAGGCGCGAGGACGAGCGGTAACGTCTAGAAGTAGTAGACTAGAGACGTCGGCGGCGTCTACGGAACCGCGACGAGCGAATAGGAGCCGCAACACAC
Strand-Sequence-397	ACATCCAACACTCTACGCCCACTAGCTCGACTCTAAGAAGCGCGTAGACGAACGGTACGTTAGACGAAGGTAGAGAGTAACTCGCTCAAGAAGCGAGACTCGCCGTTCGCGAAGAACCTAGCGGTCGGTAGACTCGGACGAACGTCTAAGGTAAGTTAACTAGTCGGTAACGAGAGAGGACGAGTTCGTAGTAGTAAGCGAACGCGTACCTAACCGCGACTCTCCTAAGCGAATAGGAGCCGCAACACAC
Strand-Sequence-398	ACATCCAACACTCTACGCCCAGCGTCGCGAGCTACCTCGTCTACTCGAGGTTACGAAGGAGACCTAGAACCTAAGAGTAAGGCGGCTAAGGCTCGACCGCGACCTACGGAAGGACGTTCGTCTCGAACGCGTAGTTCTCGTCGAGTTCGTAGAACTAAGGAACGTTCTAGTACTACGCGACTAGAGAAGGTAGACTAGACAACGAAGTCTACGGCTAACGCGGTCTCAAGGAATAGGAGCCGCAACACAC
Strand-Sequence-399	ACATCCAACACTCTACGCCCAGGACTCGCTCGAGCCTAAGCTAGTTCAAGAGGAGAACTAGCCTACCTACTCGCGCTCCTACGAACAAGAGCAACTACAACGTCTAAGGAACCGCCGGCCTCTAGTTCAACTAAGACTACGGTCTCTAAGGCAAGAACGGAACCTCGGAACCTCGAAGCGGTTACGCCGGATCGACGTAGTAGACTCTACGAAGGACTAACCTCCGGAAGGAATAGGAGCCGCAACACAC
Strand-Sequence-400	ACATCCAACACTCTACGCCCACTAGCGAAGGATCGTAGTCGGAAGCGAGGACGTCGACGAAGAGCGCGTAGACGAACCTAACCGTTAAGTAGAGGACGACTCGACAAGAAGAGTTCCTAGAAGGAGAAGGCGGTTAAGACGCTCGACTCGAAGAGAGGAACGCGACGTCGTTACTAAGGAACCTACTCGTCTAGACTAACGCTACGAGGTTCAACGTCGTCGGATCGAGGGAATAGGAGCCGCAACACAC
Strand-Sequence-401	ACATCCAACACTCTACGCCCAGCTCGACTCTAAGAGAAGGAACTCGAGACTCGAGTAGACGCAACGCTAGTAGTACGAGTTAGTACGGCTACTAGAGTAGAAGACGCTACGCTCGGAACTACGGTACTAAGTACTCCGAACGAGAGACTCTCTAAGCCAAGACTAAGTAACAAGTCGAAGGAGCTCAAGTCGCTAAGAAGTTAACGACCTAGAACAACGCGAAGAGCAACGAATAGGAGCCGCAACACAC
Strand-Sequence-402	ACATCCAACACTCTACGCCCAGGACGAGCTACCTCGCTAGGTAGTCGGAACTAACTAGCTCGTACGCTCTCGGTACCAACCTACAAGCGAGTAAGTTCTAGTTAGAAGCTACGTACTACGCCTACCTAACCGCTCAACTCAACGCGACGAGCGCTAGCGGCGTCTCGTCGTACTAAGGTTAGTACGCTCCTACGAGCAAGACCGCGTAAGCTAGTAGTAACGTCAAGAGGGAATAGGAGCCGCAACACAC
Strand-Sequence-403	ACATCCAACACTCTACGCCCACTCGCTCGAGCCTAAGTACCGAAGCGTACTCGACTCCTACGTCGTAGAGACTACTAAGACAACTACCTAGTACCGCTAGACTAACTAAGAGTAGTTAGTACTAAGAGAAGAAGACCGGTAGCCTAGGTTACGGAGAGTTCTAACTAAGTCTCAAGAACAACGAACCTCGAAGGTCGTAAGAACTAAGGAGGAGAAGTAACCTCGGCGTCGAATAGGAGCCGCAACACAC
Strand-Sequence-404	ACATCCAACACTCTACGCCCAGCGAAGGATCGTAGAACTAAGCTCAAGTCCTCGGCGGTAGTCGGTCGAGTACTAAGAGGTTCGAAGAGTAAGCGTTACTAACCTACTCGAGTTAGACGAAGGAACGACAACGCGCCTACAACGGCGGAACTAGGTACTAGAACTACGCCTAGAGGTAGTTCGTCAAGTTCAAGTCGTAACTCGCGTCGAGAACGAACGGCCTCCTAGACGAATAGGAGCCGCAACACAC
Strand-Sequence-405	ACATCCAACACTCTACGCCCTCGACTCTAAGAGAAGAGGAACGCGGTTAACTCGAAGCTAAGTTCCTCCTAAGTAAGACGGAACGAAGTAGTCGGACCGAACTCCTCTACCTCGGACTCGAACTAGACTACGAACCTCCTAGGTTACTCCTCGGAAGATCGTACAACGCTACGACCTACGGTTCGTTCGTCCTAAGTTAGTAAGGATCGAACGCCGTCTCGAACGGCGTCGAATAGGAGCCGCAACACAC
Strand-Sequence-406	ACATCCAACACTCTACGCCCTAGTCGAGCCTAAGTACGTAAGCTCCTCCTACTACTAAGAGTTACAAGTAGAACGAAGCCTCGAGGAGGTTCGCCGTCTACGTCTAAGCGAAGTTCGGCAAGACGAACGCCAAGTACCTAAGGAGAAGTTACGGCTAAGACCTACGACCTCGCAAGACCGTTCGCAACGGTTAGACGGAAGCCAAGAAGAAGTAGAGCTACAAGTTCTCGGAATAGGAGCCGCAACACAC
Strand-Sequence-407	ACATCCAACACTCTACGCCCGAAGGATCGTAGAACTAGGAACGCGCGAGTACTCGGTTCGAAGGCGAAGCCGGTACTCAACAAGACCTAAGGTACTACGGAAGTCGGAGAGAGGAAGCGAGAGAAGCGACTAGTAGTACTCGACTAGAGAACCTCGCGAGTAACAACAACAAGTTACCTAAGAGCGTCTACGCTCAAGACAAGAGCGCCGGTTAACGAAGTCTAAGGAACGAATAGGAGCCGCAACACAC
Strand-Sequence-408	ACATCCAACACTCTACGCCCACTCTAAGAGAAGAGTAAGGCCTCGAAGGCCTCCGGTTAACTAGAGAGTACTACGAAGCGTCGACTAGGAGTCGGAAGGAAGCCGGAGAAGACAAGAGTTAACAACTACAACTCCTAGACTAGAGGTAACGACTCTAACTCGGAACGTTACAAGTCTAAGGATCGAGGTCGAGAGAGAGAAGCCTAGAGTAGAGGTTAAGAACGTAGGAAGAATAGGAGCCGCAACACAC
Strand-Sequence-409	ACATCCAACACTCTACGCCCAGCTACCTCGCTCGAAGATCGTTACCTAGAACCGGAACGAGGAGCTAGTCGTAAGTCGAAGGAAGAAGGAGCTCGAAGACTCGCCTAGAAGACGCTCTAGAGACTAGGTTCGCGTAACTCGGTTACGAAGAGAGGACTAAGAACGTCGCGTAAGTCTCGTAGAGCTCGTCGAGTAACGGTAGCTCGAGCGAAGACTACAAGTAACGAACTGAATAGGAGCCGCAACACAC
Strand-Sequence-410	ACATCCAACACTCTACGCCCTCGAGCCTAAGTACGTTACAAGGCGCCTCGAGGAGGCGGAAGTAGTAAGCGACGACCGTACGACCTAGACGCTAGAGTACTCGGAACTACAAGACCGCTAGTCTAACCGGCAACTCGAGACTCTACCTAAGGTACTCGAGCCTCGGCGAACGCGCCGGAGAGTACCGACAAGAGACCTACTCGACTACTACTAGGTACTAAGAGACTCAAGAATAGGAGCCGCAACACAC
Strand-Sequence-411	ACATCCAACACTCTACGCCCAGATCGTAGAACTAGTAGAGAAGGAAGTTCGCCGGAACGGAAGAAGCGAGGAGTAACGGTTAGAAGTCGACCTAAGGCTAGTTACAACGAACTCGGACTCCTCGACTACGCGCGTAGACCGCGAGAAGCGCCTACTCGAAGAGGTACAACGGCTCGAGTACCGTCAACGGACCTAACAAGAGCGCTCGAAGGTCGTAGAGAACCGTTACCGAATAGGAGCCGCAACACAC
Strand-Sequence-412	ACATCCAACACTCTACGCCCTTAAGAGAAGAGTAAGAACTAACTAACGGAAGTAACCTAAGCGAAGCTCTACAACGCCTCGGTTAGTAAGCTCCTAGTAGCTAGTTAAGTACCAACAAGACGAAGAGAACCGGAACCGGTACCGGAAGCAACCTCGCTACCGGAACGTAACAAGAAGCTCGAAGAGAGTTACCTACTCCTAGCGCGTTAACCGTACTCTACGGCGCCGTTGAATAGGAGCCGCAACACAC
Strand-Sequence-413	ACATCCAACACTCTACGCCCTACCTCGCTCGAAGAACCAACTAGTCGTAACGCGCTCTCGCCGGAAGTTAAGGTTAGTTAGAAGTCAAGAACTCGAGTAGAGAGAAGAGACTCTAACTCAAGACGAACTCGGAAGCTAGACAAGCTACCGAAGGCGCCTACAAGGTCGGTAGAGAGGAAGGTTAGACGACTCGAAGCGCGAGATCGTCGAACAAGAAGACGTAGAGACCTGAATAGGAGCCGCAACACAC
Strand-Sequence-414	ACATCCAACACTCTACGCCCAGCCTAAGTACGTTAGAACGCCTCGGACAACTACGCTAAGTCTAGAGGTAAGAGTACCTCGAACTCGCGAGACTCGGCTAACTACCTACCGGCCTCTCGTTAGACGGCGGAACCGTCGCTAGTAACGGTAGGACGAAGAACGGACGCGCGTAACGCAACTACTACCTACGACCTCCTAACCTCTACTACAACTAAGAGCCTAACGCGGAAGAATAGGAGCCGCAACACAC
Strand-Sequence-415	ACATCCAACACTCTACGCCCTCGTAGAACTAGTAGACCGGACAACTAAGTACGAGTTCGAGGTCGTAAGGATCGAGCGAAGGTAGATCGTTAGAGTCGTAGAGAAGGAAGAACGGTTAAGCCGAAGCGTAACCTAGCTAGACCTAAGTCTAGTAAGCTCTAGAACTACTAACTCAACGCGGTTCGAACGGTCGGAGCGGCGCCTAACTACAAGGTACCTACGCTAAGTTCGAATAGGAGCCGCAACACAC
Strand-Sequence-416	ACATCCAACACTCTACGCCCAGAGAAGAGTAAGAAGAACTCGCGTAGGAACGCTACTCGAGTACCTAGAGAAGCGCTAGAAGGAGGAGCGGTAGCTCGTAACTAAGGCGGAACTAGAGAGACCTACTAAGACAACAAGTCAACGGTAACCTCGCGAACGCTAGGCGGCGGTAAGAAGGCGCCGGAGACGGAGAGACCAACGCCGTCGTCTACGGAAGAGAAGCCTAGGAAGAATAGGAGCCGCAACACAC
Strand-Sequence-417	ACATCCAACACTCTACGCCCTTAAGTACGTTAGAACAAGAGTAGAACGGAAGATCGAGTTAAGCGGAAGAAGCGAAGAGTTACGAAGCGTAGTAGTTAAGTAGAAGTACCGGAGAAGCTACGAAGAGTAAGTCGTTCGTCGCGAGCGTCTACGCCGTTCGGTACTAGAACGGTACGTACGTCGCCGTCAAGAGATCGACGACTCCTCGGTACAACAAGAAGAACAACGCTGAATAGGAGCCGCAACACAC
Strand-Sequence-418	ACATCCAACACTCTACGCCCTAGAACTAGTAGACCGCGTTCCTCGGACAACCTAACAAGTACTAGAGAGAACGCGTCGCCAACGCGACTAGGTTCGGATCGAGCCTACAAGAGTCGACTCGCGGCTAACCTCGCGCCGCGAGAACGAAGAGGTACGGAGAACTACTAAGTACCGCTAACTCGTTAACTAGACAACGCGCCGCCGTTCAACGTTCGGAAGCTCTCAACCGTGAATAGGAGCCGCAACACAC
Strand-Sequence-419	ACATCCAACACTCTACGCCCGAAGAGTAAGAAGAACGCTCGTAAGCTACCGTACGCTACGGAACCGAAGCGAGGACGTACTACAACGCCGTTCCTCGGTACGCTACCTAGACCGTTACGACTACGTACGGAAGACAACTAGAGAGAAGACTACGCGGAACCGCTAGGTTCGGCTCGTAGTAGTCGTAAGGTACTAAGAGTACGAACAACGGTAGTACGTACGCGTTCAACGAATAGGAGCCGCAACACAC
Strand-Sequence-420	ACATCCAACACTCTACGCCCACTCGAAGAACCGCCGAACAACGAAGACCTCGGAAGTCGTTAACTACGTCGCGGAGGAACGGCGTCGCGGAAGCGTAGAAGACTCCTACGAGTCTCGGACAAGGTTAACCTAAGACGAACAAGAGTCTACGCTAGTTACGAACTAACGAACCTACGTTAAGCGCGACTCAAGGCTAGTTCCTAGAGAGGTCGGAAGCCGGAACGTAGAACGAATAGGAGCCGCAACACAC
Strand-Sequence-421	ACATCCAACACTCTACGCCCAGTACGTTAGAACAAGCCGCGACGAGCCTAGAAGTCTAAGGAGACGTCTAAGGTCGGTTAACTACCGGCTCGACCTACCTAAGCTCGTAGTACGTCGGCTAGAAGAGTCTAACTCTCGGCGCCGTAACCTACGCCTAGAGCGGAAGCCTCTCGTTCTAGACGTCGGAAGTCGGTTAGTTCGGAACCAACCTCGCCAACTAAGAGTACTAGGAATAGGAGCCGCAACACAC
Strand-Sequence-422	ACATCCAACACTCTACGCCCAACTAGTAGACCGCGGAAGACGGCGCGTTCGGTTACGCGAGCTAACAAGCGAAGAAGACCGTAACCGGTAACGGAACCGCGTACTACTCGAACGAAGGACTAAGGACCAACGCGTTACGCTCGACTAGTAGGACGAGTAGGAGAAGAAGAGAGAAGTACTACGTCGCGTTCCTCGCCTAACCTACTCTCAACGCTAGGTTACTAGAAGTCGAATAGGAGCCGCAACACAC
Strand-Sequence-423	ACATCCAACACTCTACGCCCTCGAGAACCGCCGAAGGTAGGACTAACTAAGCTAAGAGACTACTCGCCTACGGTTACGCCTACAACTCGTTAACCGGCCTCCTACGAAGCGTCGGTTACCTCGAAGACGGACAACTCGGACAACAACGAAGATCGTAGAGTTAGTAAGAGAAGAGTAGAGACGCCGCGACCTACAACGTCGGTAGGACCGCCTCGAGGCGGTTAAGGTTCGAATAGGAGCCGCAACACAC
Strand-Sequence-424	ACATCCAACACTCTACGCCCACGTTAGAACAAGCCAACGCTAGTAGGCGGACTAGTCGGACCGCTCGCTACAAGAGACTAACTAGCGCCGGCTAGAGTTAACCTAAGACGAGTTACTAAGCTAGGTTAAGGCGGAACTAGACTCGGACTAACGCTACCGCTAGTACTAAGAGTACCTACAAGTCGACCTAACTAGACGGCGGTAGACTCTAGAGGAGGTACGCTCGGAGAGAATAGGAGCCGCAACACAC
Strand-Sequence-425	ACATCCAACACTCTACGCCCTAGTAGACCGCGGAAGACGGCAACTCGTTACTCGCCAACGGACGCTAACGAACTCTCGAAGGACTCCTAACCAAGAAGAGTAGCGGAACGTTCGCCTAAGCCGCCGTCCTAGAACAACGAGCTCTCTCGAGGACGGAAGAGGAACCTCGGAAGGTCTCGTTCAACCTACAAGGTTAGAAGTCGGAACAACGTAACCTACCTCGCGGCTACGAATAGGAGCCGCAACACAC
Strand-Sequence-426	ACATCCAACACTCTACGCCCTAAGAAGAACGCGCTAAGTTAACCTACGAAGGACCTCCTCCTAACGGCGCTACTCCTAGCTAGTAAGTCGGACTAACCAACTAGAACGCCGGACCTCTCTAGTTCGGTCGGACGACTAGACGCTAAGCCGCCGTACGACAAGAAGAACCTCGAAGAAGCTAAGCTAGATCGAGTCTACTAAGTACCTCGTTCTCGAGTAACGCCAAGACCGAATAGGAGCCGCAACACAC
Strand-Sequence-427	ACATCCAACACTCTACGCCCAGAACCGCCGAAGGTTCGAACCTCGCGAGTACGAGAACGTTCTAGAACTAGGAAGCCGTTCTAAGCAAGTAGTACGGTACGAGAAGACCTCCTAGACGCTAACTCGGTAAGAGGACTAACGCCGTAAGAACGAGGAACCTCTCGTAGAGAAGTTACGGCTCGTTCCTACCTCGAGAACTAACTAGTTACCTAGAACGCTAGAGGACCGTTGAATAGGAGCCGCAACACAC
Strand-Sequence-428	ACATCCAACACTCTACGCCCTTAGAACAAGCCAACGCGAAGTTAACGAGCGGAAGCAACTAGTCGAGACTCGGAACCGAAGCCGTCGGTAGGTAAGCTCCTCTAGACAACTCGTTAAGGAGGAGAAGGAGTAACAACGGCGCGAGAAGTTCGACTCGGTCGAACTAAGCCGTAAGGCGGTCGGAAGGCGTCGCTCGGTTCAAGTAGAGGTACGGCGAACGACTAACTAACGAATAGGAGCCGCAACACAC
Strand-Sequence-429	ACATCCAACACTCTACGCCCTAGACCGCGGAAGACTACCTCGGCAACCTCGCCGAAGAAGACGTCGAAGACGCCTCGTAACGCTAGTAGAACGTCAAGAGTCGGAGTAGAAGAGAAGCGGAAGTCGGTACCTAAGGACTACTAAGGTAGTAACGCCTAACCGGTTAGACCGGCTCGTAACAACGCGCTAGGTCGTACGGACGCTCGGAAGCGAGCGGTTAACTCTAAGGAGAATAGGAGCCGCAACACAC
Strand-Sequence-430	ACATCCAACACTCTACGCCCACCGCGGAAGACTACGAAGCGAGCCTAACTAAGGAACCTAGTAGGTAGTTCGGCGGCTACGTCTCGAGAACCGTCTAGACGACTAACTAGAAGAAGTTAGAAGCTAAGAGAACCGCTCGGACTCGGCGGTACGCTCGCCTACCTCTAGCTAGAACGGAACGAACGGAAGCGTTCGGCGCCGAAGGACTACGACCTCGATCGTCGTTACTAGAATAGGAGCCGCAACACAC
Strand-Sequence-431	ACATCCAACACTCTACGCCCGAACGCGCTAAGAGCGCTCGCGTCTAACTAACGTTCGGCTACAACTACGAAGGACTACAACAAGAGAGGTACGGCGGCGCGACCTAGGAAGTCGAACCTAGTAAGTAAGCCGTCGCCTAGACGTCGTTCGGCTAGAGTCTAACTACCGCGAGGAGACTACCTCTCAAGACTCGGTTCTCGAGCGCGACTACCGGAGTAAGTACTCAAGAGGAATAGGAGCCGCAACACAC
Strand-Sequence-432	ACATCCAACACTCTACGCCCTAAGCCAACGCGACCGTCTACGTCGGATCGTAGTCGACCTACAACTACGAACTAACGAGTTCGAAGTACGCGAAGAAGAACGCTAGAGACAAGTTCGGACAACTCTCGACTAACGAAGAGAGCGCGGAACGAAGCGCCGCCGAACTACAAGGACTAGAGAGATCGAGTAGAACGAGCGGCGCCGCTCCTCTAAGGACCGCTCTAGAACTCGAATAGGAGCCGCAACACAC
Strand-Sequence-433	ACATCCAACACTCTACGCCCACGGAAGACTACGAAGCCGCTAAGTTCTAGTAAGAAGCTCTCTCGAGACTCTAACGCGCCGTAGAACAAGGTACCGCTAAGAACGGTACTCTCGCGACTCGCTCGACCTACTAACGAGAGAACGCCGTCTAAGCCAAGAAGACCGTCGCGTAGTACGGTACGAGAAGGACTCGCAACGAACGCGGTAACTACGGTTACGCGTACGGAAGGGAATAGGAGCCGCAACACAC
Strand-Sequence-434	ACATCCAACACTCTACGCCCTAGACTAAGAGCGCTCGGAGTAGGAACGGTACGAGTAACGGAACTAGGAACGCGACCTAAGCCGCTACCAAGACTACCGCGAGTAGGTTCTAAGTCTAAGAGTTAACCGTTACGAGTAGTCTAACTAGAGAGACGTAGGAAGAAGCCGGTAGAAGTAGGACCTAAGCGAGTTAGAAGCGCCTCGGTCTCGAAGCGAACCTCTAAGAGGAAGAATAGGAGCCGCAACACAC
Strand-Sequence-435	ACATCCAACACTCTACGCCCGAAGGTTCGAGGAGCGCCTACAAGAGTAGTTACTCGTTCTAAGGAGAAGGAAGACCTAAGAGGTACGGTTCGAAGACGAGCAACGGAAGTACGAACGAACGCGGTCGGAGTAGCGCGACGAAGACGACCGGTAACGCCGCGTTCGTCCTCGGAAGCGGCTACAACCGTAACTCGAGACCTAGTAGCGCCGTAAGATCTAACTCTAGAAGCGAATAGGAGCCGCAACACAC
Strand-Sequence-436	ACATCCAACACTCTACGCCCACCAACGCGACCGTCTAAGCTAGAAGAGACGGCAACGGAAGTACTCGAACCGCGGAAGTCGAACGCCTAACTAGCGGTTAGTAAGCTAGTCTCTCGTAGGAAGCTCGGAGTTAGACCGTACGCTACGGTTCGAGTAAGTAGTTCGCTAAGAGCGCTACGAGAACGTTCGTCGCGTTAGACGTCTAACGACCTCTCGCGAACTAGAGATCGGAATAGGAGCCGCAACACAC
Strand-Sequence-437	ACATCCAACACTCTACGCCCGAAGACTACGAAGCCGCGAGTCTACAAGAAGTCGGCCTAAGCTAAGAAGAGAGCAAGAACGCTAAGACCGTTCAACTCGTCAACCTCAAGTACGTCTAGTAACTCTCGTTAGACAACCTCCTAAGTTCGTCGAGGTACTCGAGGTTACGAACCGCGTTAAGTAACGGTAACAAGAAGACTCAAGGCCTCCTCGGCGGCTACTACGGCGGCGAATAGGAGCCGCAACACAC
Strand-Sequence-438	ACATCCAACACTCTACGCCCACTAAGAGCGCTCGGTAGTAGAGCGCGTCGACGTAACTCGCTAGGTAACGAAGTAGCTCGAGCTCGACCTAGTAGTTAAGTAACGGTAGAGAAGCGACGAGAAGTAGAACGACCTCGAAGAACGGTAGTTAACTCGGTAACCTCTAGACCTACGCCTCGTTAAGCGCGACTAACTACGGCGAACAAGGTTAGACTCGCGGTACCGGATCGGAATAGGAGCCGCAACACAC
Strand-Sequence-439	ACATCCAACACTCTACGCCCAGTTCGAGGAGCGCCTAACAAGTCGCTCTACAAGGAACCGGCTACCTAAGGACTAGTAAGAGCCTCTAAGTCCTAACTCGAGAGGAACAAGTCCTACAACAAGAAGCCTCGAACTAGTACGGAACCGGAGAAGAACCTCGCTAGAAGGAAGGCGCCGCGACTACTAGGAGAGAACCTACGACCAAGTACGTCCTAGAGTTCAAGTTACTCGAATAGGAGCCGCAACACAC
Strand-Sequence-440	ACATCCAACACTCTACGCCCAACGCGACCGTCTAAGGAGAAGAGTAACGCGAACAAGGAACTCCTCAACTCAACGTCCTCGGCGCCGAACGCAAGACCGCCGGAAGCGCCAAGAGTAAGACGACCGAAGAACAAGCCGTTCCTCTCGGCGTCGGACTAACTACCGCCAACTCGTTAGACTCGTACGGTTAGTACAAGTTCCTAGAGAACAACTAACAACAAGGTAGCGGTGAATAGGAGCCGCAACACAC
Strand-Sequence-441	ACATCCAACACTCTACGCCCAACTACGAAGCCGCGTTCGCTAGGAAGACGAGTACCTAAGGTAGTAAGACGGAAGTCGGACTAAGTAACGGCGGCGGTAACGCCGCTACGAGAGACCTAACTCTCCTACCTCTCAAGAGAACCGTACGCCTCGTCGCCTCCGCGTCGTTAAGAGACTACTAAGCTCAAGCTAAGAAGTTACCTAACTAACAAGCCAACGGAAGACCTACCGAATAGGAGCCGCAACACAC
Strand-Sequence-442	ACATCCAACACTCTACGCCCAAGAGCGCTCGGTAGTTAAGTACTCGGTCGAGTTAAGCTAACAAGAGTAAGTCGAGTAGCAAGAGCCTAACGTACGCCGCTCAACTACTACCTACGTTACGCGGCGGTACCGCTCTCTAGAGTAACGCCAACTAGAGCAACTAAGACTACCTAAGATCGTTACCTCGAAGGACGACGAGGTTAGACGAACTACGCTAGACGTTACCTCAAGAATAGGAGCCGCAACACAC
Strand-Sequence-443	ACATCCAACACTCTACGCCCTCGAGGAGCGCCTAACGCAACGGTCGGAACTAACTCGCGAGACTCGCCGAACGCGGAACGTACGAACTAGCTACTCAACTCGGAAGTTCGAGAGAAGGAACCTAAGTCGCGAGACCTCAACTAACGACCTAAGCCGGCTAGAGGACGTACGCTACCTAACCTAGTACGACTAGCGTCGCTACCTACTAGAAGAAGACTAAGTAAGGTCTAGAATAGGAGCCGCAACACAC
Strand-Sequence-444	ACATCCAACACTCTACGCCCTACGAAGCCGCGTTCGCTAGGAACGCCGGCCTACCTCTCTCGTTCGGTACTACCGAAGCCGTACTAACCTACAAGTCGTAGAGGACGGAAGCCTCGAGGTACAAGTTAACTAGACTCGGAAGCGCTACCGGTAGAACTAGAGAGAAGAGCGAAGCTCCTCCTACCGTCGAAGAAGGTAGCTCTCGAAGCGGCTAGACCGTTAAGAGTAGCGAATAGGAGCCGCAACACAC
Strand-Sequence-445	ACATCCAACACTCTACGCCCAGCGCTCGGTAGTTAAGTAGTACCGTAAGATCGTAGAGTAACCTAGACGCCTACGTCGTCGAAGAAGAGAGCTCGAGTAGTAACGGTTCGTCGAGGAGGACTAGTAACGGCGCGACGAAGAGCTCGAGCGGTACTCTACAAGCGTTAGACGCGAGTTAAGACCTAGAGTAGTACGCCGTAGGTAACGGCAAGACGTAGAGTAGCTCGACCGAATAGGAGCCGCAACACAC
Strand-Sequence-446	ACATCCAACACTCTACGCCCACCGTCTAAGGAGAACGAAGCCTAAGGTACCTCGTCGCTACTAGGACCGAAGAAGGCTAACTAACCGCTCCTACCGTTCTCGGATCGTCGTTCTCGACGAAGACTACCGCCGGAAGGTCGACCTAACGACCTCTCTACCTAAGTAGTCTAGAACGTTAAGCGTACGGTACTAGGAACAACCTACGCGGAAGAAGTCTACGAGAGAGTAGAGAATAGGAGCCGCAACACAC
Strand-Sequence-447	ACATCCAACACTCTACGCCCGAAGCCGCGTTCGCTAGATCGTACCTAAGTCTCTAAGAGAAGTTCGTCAAGACCGGTAAGTCGTTACTCGAAGGACGCAACTCGAGTACGACGTAGACCTAGGAAGACCTAAGTACCTACAACCTACCTAGGTACTACGCGACCGAAGGAACTAGTAAGTTAAGAACGTTAGACAAGAACGGTAGCGGTAACCTAGAACCTACGTTCGAAGAATAGGAGCCGCAACACAC
Strand-Sequence-448	ACATCCAACACTCTACGCCCACTCGGTAGTTAAGTCTACAACGCTAAGGCGAAGACAACTAGTTACGCTACGAACGCGAAGAGTTACTAACTCGGTTCTACTACCTCAACGGTTCGTACAAGACTAGTACGTTAAGCCTCCTCGGCGCTAGTAGGTAGTTAACTCTCTACGCTCGACTAGAGACGACCAACGTCGGCCTCGCCGAAGGAGAGAGCTCGCGGAGAGAGTAGGAATAGGAGCCGCAACACAC
Strand-Sequence-449	ACATCCAACACTCTACGCCCAGCGCCTAACGCAAGTAGAGAGAAGGCTAACTCGAACGCAACGGTACCGTTCTACAACTCAACTAGTAACGCGCTACTACCTCGAAGACCGGTAGCGCTAACGTCAAGACGAAGTAGTTACTCTACGCGTCGTTAGTACCTAACGGAGAGCGGACTCAACAAGCTCAACAACGAAGCCTCGGAAGCTAACCTCGGTTACAAGCCGAAGGTGAATAGGAGCCGCAACACAC
Strand-Sequence-450	ACATCCAACACTCTACGCCCAGGTAAGGAGAACGAGAACGAGAGTAAGACGGCTAACTACTAGAGTTCGGCGGCTCGTAGTTACGCCTAGAAGCTCGGTCGTAAGAAGTCGTCGTCCTCGTCGCGAAGAACGAAGGCGCGAGTAGTACTAGCGCTCGCGCCGCTAACCTAGACAACGCGTTAACTACGTACGCTCAAGGTACCGTAAGTAGACAAGCGTAAGGTAGTAGCGAATAGGAGCCGCAACACAC
Strand-Sequence-451	ACATCCAACACTCTACGCCCGAACGCCTAAGTCTAAGTTACGCTAACTCGACGAGGTAAGGCAAGACTACCGCGTAACTACCTCTACTAGAAGCTAGAACCTAACGCCTACCTAACCTAGAACTAACTACCGTACTCTCGTACGGCTACGAAGACAAGACCTAGACGACCGCGTTCGGCGCGAGTACGAACCTACGCTAAGCGACTAACGCTCGAACGTTAACTCTACAAGAATAGGAGCCGCAACACAC
Strand-Sequence-452	ACATCCAACACTCTACGCCCACCTAACGCAAGTAGAAGACTCGCGAACGCGCCTACGGTTACCTCAACAAGTACTACTAGTCGTTCGCGACTACGAGTCGGAACGCGGAAGGTCTAACGTACGTCGCCGTCGCTACTCCTACTCGCTAGAAGTTAACTCTAGAGACCTACTAGACCGAAGCTACCAACTAGTTCGGCGCTAGAACGACGAGAGACGTTAGAAGTTAGACTGAATAGGAGCCGCAACACAC
Strand-Sequence-453	ACATCCAACACTCTACGCCCTAAGGAGAACGAGAAGTCGGCGAAGGAAGTAGTCTCGCCGTAAGAAGGACGACTAAGAGTCTACGCAACGGCGCCTACAAGACCTACTAACAAGCGACGTACGTCGTCGGAACGAGGACTCGGACTAACTAGACGAGCGAACAAGAGACCGTAAGAGAAGAAGGAACCGTCGTCTACTACGGACTAGAGAACGGCGAACTCTACCTCGCGGAATAGGAGCCGCAACACAC
Strand-Sequence-454	ACATCCAACACTCTACGCCCACGTTCGCTAGAACTACCGTAGAGTAGAGTAACTAAGGCGGCGGACTCAACGTCGAAGACCTCTACTCGACGTTCAAGTAAGAGTTCTCGAAGAGCTCGTTAGACCTCGCCGAACAAGCGTACCTCTAGTTAAGTTAGAGACTAACGAAGACGAACTACGGCGCGACCTAAGCTACGTACTCGTACCTAACTAGGTACGCCGCCGGTAACGAATAGGAGCCGCAACACAC
Strand-Sequence-455	ACATCCAACACTCTACGCCCTAGTTAAGTCTAAGTTAACTAAGGTTAAGGTAGAACAACGAAGCTAGGACTCTACAACCTCGGAGTAGGAGCGTCGCTCTCCTCGTCGTCTACGTCGGCTAGTAGTTCAACGGCGGAACGACTACGAGAAGCGAAGGACGCGCCGAACGCCTCCTCGGCGGCTACAAGTACGTCGTCTAACCTCGACTACGCAAGTACGCGACTCCTCTAGAATAGGAGCCGCAACACAC
Strand-Sequence-456	ACATCCAACACTCTACGCCCTAACGCAAGTAGAAGAGAGACAAGAGGACGTCGTCGAGTTAGTACAAGTAGTACCTAAGTTAGAAGAGTCTACTAAGCCTAACCGTCGGTAGAACGTACTAGAGCGGACCTCTCAACGTCGAACTCTCGAACGCGTTCAACTAAGCTCTCAACTAACAACAAGCGACCGCCGCGAGTACCGCGTAACCTAGGAACCTCGAAGTCCTCGGAGAATAGGAGCCGCAACACAC
Strand-Sequence-457	ACATCCAACACTCTACGCCCAGAGAACGAGAAGTCCTACCTAGAACGAGGTACGGCGGCAAGTTAAGGTAACCTAACTACGGCAAGTTCCTAGAGTTACGAAGAGACAAGTAACAAGGACGCTAGTAAGAAGCTCTCTAACGCTACAAGTCGTACCTCAAGAAGTACTACGCTAAGAGTAGATCGACGTTACGATCGAGCTCGTACAAGACCGCGTCGAGACAAGACGTCGAATAGGAGCCGCAACACAC
Strand-Sequence-458	ACATCCAACACTCTACGCCCTTCGCTAGAACTACCTAGAGTCTACAACTACGCTCGACCGCCAACGGTAGAGAACTCAAGTTCGCCTAGTTACAACGCGCGACGTAAGCCTACAAGAGGAGGCGGACTCAAGAGTTACTCGCTACGTAGGAACTAGACTCGTAAGGTTACTAGAACGAACTACGAACCGTCGCGAGAACCGTACCTCGGTAGTTCGTCGCTCGAAGTAGAGAATAGGAGCCGCAACACAC
Strand-Sequence-459	ACATCCAACACTCTACGCCCTTAAGTCTAAGTTAACAACGCGGCCTCGGAACGTTAAGGACGAGCGCGAACGGCTAAGAACTAGAACGAGAGAGGTTCGAAGTCGGACGCAACGGAACCTACAAGAGTAACCTCGGCGCGTTACTACCTCGCCTAACGACCTCGACCTAGTAGTTCGGACGCGTCGCTAGCAACGAAGCGTCGTACGTCGCCTAGTCGAAGACTCGGTACGAATAGGAGCCGCAACACAC
Strand-Sequence-460	ACATCCAACACTCTACGCCCTAGAAGTAGAAGAGAAGAAGAAGACGCGCGTACTAAGCCGTTCCTCAACGAACGACGAAGTAACGCGCTACTCGGTCGTAACTAGACTCGACCGGTAGTCGGAGTACGAACGCTAGCTACAACTAGTACGCGAGCAAGTTACGCGAACGCTAACCTACGTTCAACGCCTAGTTAAGCGTCGGCGCCAAGAGTAGAAGGACTAAGTACGAAGAATAGGAGCCGCAACACAC
Strand-Sequence-461	ACATCCAACACTCTACGCCCGAACGAGAAGTCCTACTAAGGTAACGACGCGTCGGTAAGACTACTCGGAGCGTCGAACGACGCTACGCGACGGAACCTCGACTCGCTCCTAACGGCAACTACTAGTTAAGTAGGAGCTACGGCGGCGGTCTCCTCAACTACTAAGGCAACGGATCGGAAGTCTCCGAAGGTACGAAGAGCGGTAGGTTCGGTACTCTAACGAACGTACGAGAATAGGAGCCGCAACACAC
Strand-Sequence-462	ACATCCAACACTCTACGCCCACTAGAACTACCTAGTACGGCTCGACTCGGTACGCTCTCCTCGGTAGGACGGAAGACGGTCTAAGCGGCGCGACTAGAACGTTCCTCGGCGAAGAACTAACTAGAGAAGTCGGCTAAGGCGGCCTAACCGAACTAGCTCGAAGACTCGGAGAAGGTCTCTCGACTCTAACTACCGCCTAAGAGTTACGACTCTCTAGCGGATCGACTACGGAATAGGAGCCGCAACACAC
Strand-Sequence-463	ACATCCAACACTCTACGCCCAGTCTAAGTTAACAAGGCGTCGCGAACTAGAGAGAGTAGTTACTAACTAGCGGTAAGTAAGGTTAGAAGTTACGATCGAACTAGAGCGCTAAGTTACTCTCGAGCAACAAGTAAGCCGCGTAAGAAGGCGCGACGTACGAAGGCGCTCGCTACGCTAGTTCGACTAAGTCGACGGAAGCTAAGTAAGACGCTCTCGGCGGATCGTTCTCGGAATAGGAGCCGCAACACAC
Strand-Sequence-464	ACATCCAACACTCTACGCCCAAGTAGAAGAGAAGAAGGAGTAGCGTCGGACCTAGGTTCGCTCGGAGGAGGTACGTCGGCTAAGCTACTACTACTAAGAGCGTCTACAACAAGAAGAGTAGCCTAAGTAGGAGAGAAGGCCTACCTCGCGCCGCTCTCGCCGTCAAGACCTCGAGAACCGTACGCTCGTAGAGTTAAGACGAAGACGAAGAACGCGTCCGTACCTCGACCGAATAGGAGCCGCAACACAC
Strand-Sequence-465	ACATCCAACACTCTACGCCCAGAACTACCTAGTACGAAGTCGCTAGGTAACGAGAGTCGAACGGCGGTAGTACCGAAGACTAAGCCGGAAGGTTCAAGTTCTCGAGGTACGCGAGAACTACTCTCTACGCGTAAGGCAACTCGTACGCGTAGAGAAGTAGCTACCTAAGCGTCAAGACTCTAGACAACGGTCTACTCGCTAGAAGAGACGGCGTCTAGAGCGGAGAGAACGAATAGGAGCCGCAACACAC
Strand-Sequence-466	ACATCCAACACTCTACGCCCTTAAGTTAACAAGGCGCTACTAGTACGACTCTAAGATCGTAGAGCGGACTACAACGCTAGACCAAGAGGACCGTCTACAAGTACGAAGGCCTCTAACCTACTAGAAGCTCGTAGTTAAGGTAGAGAACGAGCGCGTCGAGGACTAGGAACTACCTAACCGTTACCGTACGCTAGAAGAGTAAGTAGAGGAGGAACTAGACCGAGACCGCTGAATAGGAGCCGCAACACAC
Strand-Sequence-467	ACATCCAACACTCTACGCCCTAGAAGAGAAGAAGGAGTACCGCCTAAGGTACTACGACGACCGGCGTCTACGCGACGACGTAGAAGACCGTCGCCGCGACGTTAAGTAGGAAGAGCCTCCTCTACGCTAACGGCCTAAGACAAGAAGGAAGCTAGAGTTCGACTCGCCTCTAGTACTACGCCGCCGGTAGGACGGAAGACAAGTAAGCGAACTCCGTAGTTCGAACGAGAGAATAGGAGCCGCAACACAC
Strand-Sequence-468	ACATCCAACACTCTACGCCCACTACCTAGTACGAAGACAAGTAACAACGCAAGTAAGACGCCGTAGAACCTCCTAGTTAACCTAACTAAGCTAGGTAGTTCGGTTAGAGACCTAGGTCGAGAACTAACCGGTACTACGGACGCAAGAGGAACGGCGGAACGAAGTACGGAGAGACCGTAACGTTCTAACGCGCTCCTCTCTACGCCTCGTAGAAGAGCTAGTCGACGACCGAATAGGAGCCGCAACACAC
Strand-Sequence-469	ACATCCAACACTCTACGCCCAGTTAACAAGGCGCTAACTCGACGTCGGAACAAGGCGGTTACGGTAGGACTAACGGCGCTAGGAAGTAAGAACTACTAAGTAGACTCGGTAACAACGGTCTCCTCGCTAACGCCGGTAGAACCTCGAAGAGTTAACCTCAACGCCTCTAACTAAGACGCTAAGCGACCGCGTACAACGCCGGCTAACTCGCTACTCCTACCTAAGAGAGAGAATAGGAGCCGCAACACAC
Strand-Sequence-470	ACATCCAACACTCTACGCCCAAGAGAAGAAGGAGTAACGAAGGCGAAGAACGCGGCGCTAGAGAAGACGCCTAGAGAACTCTAGAGTCGTAAGCGGAAGGTAAGAGACCTACTACCGTTCGACAACTCTAGAGACCTAACGCCGCTCTCGCTAGTCTAAGCGGTAGGACCGTCGCTAGGAGCCTAAGTAGCGGCAAGAACGCTCCTCGCCTAACCGTCGCGAAGTTACCTGAATAGGAGCCGCAACACAC
Strand-Sequence-471	ACATCCAACACTCTACGCCCAGGTTACTAACCAACAAGACCGTCGGTAGACAAGAGTAGTTCGCCGCCGCCTACGCTAACAACGCGACCGCTAGCGCCAACAAGAGTAACTAGACTCCTACTACGTTACGAGAACGCGCTAGTTAAGGCAAGGAAGCCGTTCAAGTCTACAACGCTAGTTACGGTCTCTCGAACGCTCAAGTCGGTTACGTCGAACAAGCTAAGTTAGAAGAATAGGAGCCGCAACACAC
Strand-Sequence-472	ACATCCAACACTCTACGCCCACCTAGTACGAAGACGTCGAAGCTAACTAAGTCGGCCTCGAAGAACGCGAACTCGCTACCTAGAGTCTACTAGACAAGACGACGAGACTAACGACTCGACTAAGCGGTAGTTACGTCTAGACCGCTCCTCTACGCAAGAGACGCCTAGAAGGAACGTTCGCGTCGACGTAAGAGACGAGAAGCGCGACCGTCGGCGCTCTCTAGTTCTCGGAATAGGAGCCGCAACACAC
Strand-Sequence-473	ACATCCAACACTCTACGCCCTAACAAGGCGCTAACGCCGCTAGTACTAACCTAAGCCTCGCCTAGAAGAGCGAAGCGACCGAAGACGTCTCGTAACTCGGCTAAGGTTAGAACCTACCTAGGACGGAAGTTCCTAGGTTAAGCAAGAGGTTAGGCTACGCTCGGAAGACCAAGGAAGCCTAAGCGTTACTAAGAAGGTACGGTACGTTCCTAAGTAGATCGACTAACTAGGAATAGGAGCCGCAACACAC
Strand-Sequence-474	ACATCCAACACTCTACGCCCAGAAGAAGGAGTAACGAAGCCGCCGCGTTCGAACTAGAGAACTAAGAGAGGTAACCTCGAACGAGCGCCTCGACGTTAAGGAGCAAGTACGGAAGGAGTTAAGCGTCGTAGAGTAGCGGACGCTAACTCGAAGTCGCCGAAGCTCGAAGTAACAACGCGAGTAAGACCAAGAGGAGTTACGAAGAGTTAGAAGAAGCGAGACGCTAGAGAGAATAGGAGCCGCAACACAC
Strand-Sequence-475	ACATCCAACACTCTACGCCCTTACTAACCAACAAGACTCGGCGGTTAACCTAAGCGAACGCCAACGCCAAGAGTACTCGCGCTACGTAGAGGAGTTCGAAGAAGGAAGAGAGGTAGTAAGCTCGCGCTAGCCTCGTCGCGTCGAGGAAGACTACCGTCGAACTCTCGAACGGAAGTAGTCTCGGACTCAAGAGCGCTCGAGAACAAGTCGTCGCGTAAGCCTAGTAGTCGGAATAGGAGCCGCAACACAC
Strand-Sequence-476	ACATCCAACACTCTACGCCCTAAGGCGCTAACGCCTCGTTAAGAAGGAGAGAGTTAACCGTCGGCTCGACGACTACCGTCTAGAGGAAGAAGACGTAGGAAGACGCCTAGTTACTACAAGCTACGTAAGGCGTCAAGTTCGGACTCTACTAGAGCGCTAGTCTCTAAGTCAACGCGACGACTAGAAGGAACGCTAGGACGTACCTACTCGCGTACTAAGTCCTCGGCGGCGAATAGGAGCCGCAACACAC
Strand-Sequence-477	ACATCCAACACTCTACGCCCAGAAGGAGTAACGAAGGAGACTAAGCGTAAGACAACAAGAGTCTACGAAGAGAAGCTCAAGGTAGCTCGAGACTCGGCGGCGCTAGACCTCGGACTACGAGAAGCAACAACGCGAGGCGGTAAGCTCCTCGCAAGTCGAAGAGACGCGGCCTACGAGGAACCTACGGTAGAACGACCGCTAAGAACGGACTAGAAGGACGCTCTCTACCTGAATAGGAGCCGCAACACAC
Strand-Sequence-478	ACATCCAACACTCTACGCCCTTAACCAACAAGACTCTAGAGACGAGTTAGTAGGAAGCGACTCTAAGTACTCTCGGCGTCCTCTCGTAGGAAGAAGTCGTCGTCGAACCTAGTTAGACTACTCTAGACCTAAGCCTCGCTACTAGAAGTAACCTCGCTCGAAGACTCCGCCTAAGGTAAGGTCTCGGAGAAGTCGCCGTCAACTAAGGACTACGCAAGTCGAACTAACAAGAATAGGAGCCGCAACACAC
Strand-Sequence-479	ACATCCAACACTCTACGCCCTACGAAGACGTCGGCTACCTAAGCAACGCCGAACCTCTAGAGACTCCTAGGTCGAACTACTCGAGGAGTTCGTAGAACGGCGCTCAAGTCGGCTCGACCTACTCGAGTAGTTCGTTCTAAGGTAGTACCGCGTTCGCCGTCTACGCTCGGTAAGAGAGGTAGTAACGCTAACAAGCTCTACAACTCCTAACGAACTAGAAGAACGGTTCGGAATAGGAGCCGCAACACAC
Strand-Sequence-480	ACATCCAACACTCTACGCCCAGGAGTAACGAAGGAAGGTTACAACTCGTCTCGAGAACGAAGACTAGTACTAGTTACGGCTAGTTAACTAGCGCGTAACTCGAAGGAAGACTCCTAAGATCGTAAGACGCTCGCGTCGTCCGAAGAGAACAAGAGACCGAAGGTCTACGCTAGTAAGCGGAAGGTCTCTAAGAGTTAGAAGAGAGGTTAACTAACTACTACTCGACGACCGAATAGGAGCCGCAACACAC
Strand-Sequence-481	ACATCCAACACTCTACGCCCACCAACAAGACTCTAACCTAGACGTTACTCCTAAGACTAAGAAGGACGAGTTAAGAGACTCGACAACTAAGAACCGCCTACGGCTCGACGACCGCTAGTACCTAGAGCCTCGCCGCTACTAAGACTCTCGCTCGATCGAGCCTACTCAACAACGGCGGAACGTACGCCGCTAGACTAAGGAAGTAAGGACTACTAGGAACTAGAAGTAGCGAATAGGAGCCGCAACACAC
Strand-Sequence-482	ACATCCAACACTCTACGCCCGAAGACGTCGGCTACTAAGAACCTCTACGCCTACGCCTCCTCGCGACTCGCGCGACCGTTAGAAGAGAAGGCGTCAAGAGACAAGCCGGCGAAGACGAAGAGAGGAGCCTCTACTAGAGACTAAGGAACGTACCTAGTCTACTAACGTTCGCGACGTAGACCAACGTCGAAGAAGCGAGGTCGTAGTTCCTCGCGAGACTCAACGAACAAGAATAGGAGCCGCAACACAC
Strand-Sequence-483	ACATCCAACACTCTACGCCCACTAACGCCTCGAGCGGAAGCTAGTACTAGTAAGGAAGCGTCAACTAAGCCGCCGCGAGGTCGTTAACTCTCGTCGGAGAAGGTTCGAGAGACCTCCTCCTAAGTTAAGCGAGCAACAAGAGAAGTAGAGACGCGAGCGTCGCCGGCTACTCGTTAGACGTAAGCCTCAAGTAAGTCCTAGACGCCGTTCGCGGAAGTTAACGCGGAGGTGAATAGGAGCCGCAACACAC
Strand-Sequence-484	ACATCCAACACTCTACGCCCAGTAACGAAGGAAGGTTCTCGGAAGCTACCTCGAGAGACAAGAGGACGAGCTACTCGTAGAGCGCGTAACGAGAAGTCGCCGTAACCGCGAACTCGTAGTACAACTCGAGAGAGACTCCTAGTAGCTAAGACGGTAGAAGAGAAGGTACCGGACAACGAACCTCGAGCTAGGAACTCGCGAGGTAAGAAGGCCTAACTAGGAGGTTCGGAGAATAGGAGCCGCAACACAC
Strand-Sequence-485	ACATCCAACACTCTACGCCCAACAAGACTCTAACCGTTCAAGAGTCGACCGCGTTACGACAACCTCGGAAGAGCTACGCGTTCCTCAACGGCGCTAGAAGGAGGAGCGCTAGGACCTAGAGTTCGTTCTAAGCGACGTTCCTAAGAAGCAACGCCGGAAGGTTCGGCGGCGGCCTACAACGCTCGACCGTTAACTCCTAACTAAGGACTAGTACTCCTCGTACGACCTCTGAATAGGAGCCGCAACACAC
Strand-Sequence-486	ACATCCAACACTCTACGCCCAACGCCTCGAGCGGAGAACCTACTCAAGCGTAGAGGTAAGCGAGATCGTCGTTAAGTCTCAAGACTCGGTACGCCGTTCGAAGTTAAGCCGGTAAGTACAAGTAGAGCGGCGGACTACTAAGTTAGAGTCGGTTAGAACGCGAAGAGTAAGGTCGGTACGAACCTCGACTACAAGGTACGAAGAGTTCGTAGTTCAAGAGGTCGAGGTACGAATAGGAGCCGCAACACAC
Strand-Sequence-487	ACATCCAACACTCTACGCCCAACGAAGGAAGGTTCGCCGGTAGTCGGACGGAACAAGCCGTTAGGTTAGAGTCGTAGAAGAGCTAGTCGACTAGTAAGACTCTCTCGTAAGCCTAGAGACTAAGACTCGTCTAACTACGACGCTCGACGAGGAAGAGTCGGAGCGTCGGTAGTTAAGAGAGTAAGAAGAGGTTAAGGAACCTACTAGAAGCTACGACTAGGACGTAGTTAGAATAGGAGCCGCAACACAC
Strand-Sequence-488	ACATCCAACACTCTACGCCCAAGACTCTAACCGTTCAAGAGAACGGCGGAGACTCGAAGTTACAACGAACTCGCTCGTAAGCCTACAACGCTAGCGGACAAGGAACCGGTAGACGCTCGTAGAGTAGTAAGAACCTCGCCGAACTCGCGTTCGGAAGTTCGAGAACGACGACCGGCCTCGGAAGGCGGTAAGAACTCGCCGCGTAGACGACCGTACTAAGTAGGAAGTTAGAATAGGAGCCGCAACACAC
Strand-Sequence-489	ACATCCAACACTCTACGCCCAGGAGCTACTAACGCGCGAGGAACGCTAAGAAGTTACGACGCAAGTAGAGTTCGACGAGCAACGCTCGGTAGACCTAGAAGACCTAAGCGTTCGAACTCCTCGTCGCGAACTAGTCGGAAGCCGGTACTAACAACAAGAGCTACAAGACGAACTACGTCGCTCTCTCGAGACTACGATCGAAGTACGCGTTACCTCAAGACGGTAGAACGGAATAGGAGCCGCAACACAC
Strand-Sequence-490	ACATCCAACACTCTACGCCCGAAGGAAGGTTCGCCGGTAGTAACTAAGCGTCGACTCGAACCAAGACTAACGGCTCGTAGTACGCTCAACGATCGTTAAGGAAGTACTCGAACAACCTCGGCGGTACTCTCGTCAACAAGAGGACCTCGTCGACCTAGGAAGCGACTCCTCGGACCAAGTAACGAAGTCTACCTCCTACGACGTACGGCGGCTAACTAACGAAGTACGCCGAATAGGAGCCGCAACACAC
Strand-Sequence-491	ACATCCAACACTCTACGCCCACTCTAACCGTTCAAGAGTACGCCAACCTCGAACCTAAGACGTAAGGCTAGTCGTACTAGAAGAACGCCGGCCTAGAGACGGAACGAAGTAACAACGCTACTACCTACTAGAGAAGTACCTCGGAAGGCCTCAAGAGTAGGAACGAAGAGTTAACCTACCGCGGTTAACGCGCGAACCGTCAACGCGCGAGATCGAACAACGTCGCGAGGGAATAGGAGCCGCAACACAC
Strand-Sequence-492	ACATCCAACACTCTACGCCCAGCTACTAACGCGCGTCGAGTCGGACGTACGCTCGGTAGTCGACTCTAAGTTAAGGTCGGAACGAAGAACGCTAAGAAGTCGTCCTACTAACCTCGGAAGGCGCCGCCAAGGAACGAAGCAACCTACTCTAGTCGTTCTCGAAGTAAGTCGTCTAGTTCCTCAAGAGAACTAGAGAAGAGTTCGGTTAGAGCGGCGCGTAGTTCGTCTAAGAATAGGAGCCGCAACACAC
Strand-Sequence-493	ACATCCAACACTCTACGCCCTCGAGCGGAGAACCTAGACGCAAGACCGCTCGAAGAGAGAGCGTCTAGACGACCGTCAAGAGTCGGTCGTTAACTACCAAGTAGTAAGGTAGCGCGTACTACTAGAGTTAGAGTAACGTCCTCGCCGCTACTAGCTAACTCTACGGAACCGCCTAAGAAGAAGGTTCGAGGAGTAGGTCGTAGACTCTAGAGAGGTAGAGTACCAACTAGGAATAGGAGCCGCAACACAC
Strand-Sequence-494	ACATCCAACACTCTACGCCCAGAAGGTTCGCCGGTCTCGAAGTCTAAGTCGCGTAAGCCGTACTACAAGCGACGGAAGCTAAGACCTACTAAGAGAGATCGACTAAGAAGACTCGGTTCTAGTTCGGTCTAGAGAGTCGGAGCGAACAAGCGTAGAGACAAGAGACTAGGAGTTCGAGTAGTTAAGCTCGCGCCGGCGGTACGAGGACGTTACTACGCGGAAGTCGGTTAGAATAGGAGCCGCAACACAC
Strand-Sequence-495	ACATCCAACACTCTACGCCCTTAACCGTTCAAGAGTTCGCTACTAGAGAGTAAGACTACGAAGAGAGTACGAGAAGGTCGGAAGGCGCTCGAACTAGGTAACGAGAAGCTAGCGCGTTCTCGACGACTACGAACGGCTACGGAGAACGCGTCAACTAGTAGAGCGAAGCCGGTTCGGAAGAAGGCGGTTAGAAGTAAGCGAGCGCTCCTAGGAGAAGCGGTCTCCTACTCGAATAGGAGCCGCAACACAC
Strand-Sequence-496	ACATCCAACACTCTACGCCCTACTAACGCGCGTCGTTAACTCGCGGCAAGAGGACGAACAAGACTAAGGAACAACAAGACGCTCGCAAGACTACCTCGAAGTTCGGTAGGACTCAAGAAGCTCTACAACTCGGAACTAGCAAGTTCAAGTACTCGTACCAACGCGAAGTCGGACGCAACGGCTAAGGTACCAAGACTAGGAGTACGTTAGAGTAAGTCGCGAGACTAGTCGAATAGGAGCCGCAACACAC
Strand-Sequence-497	ACATCCAACACTCTACGCCCAGCGGAGAACCTAGACCTACCGTAGAAGGCGGAGAACGAAGCTACTACGCCGGCAACTAGACGAGGAGCGGCGCGAGTAGCAAGAAGAGTACCAACGAAGGCTAGTTCTCGTACGCTCTCGTCCTACCTCGGTAGTAGAGCAAGTACCTAAGAGAGTCGACTAAGACCGTTCGAGACGGTCTAAGTACCGTCCGTTCGTCCGAACGTTAAGAATAGGAGCCGCAACACAC
Strand-Sequence-498	ACATCCAACACTCTACGCCCAGGTTCGCCGGTCTCGGTAGACAACTCTAAGCCAAGAAGTAGACCTACTACTAACAAGCGTTAACGACGTTAAGCTAAGAGACCGTCGGCGAAGAAGTCAACGGCGTCGCTCTAGACTACAACTAACCTCTCGAAGGCCTCGGTACTCCTACTAACGAAGCCAAGTACTAGTACGCGACTAGACTAAGAGAAGGCGCGAGCGGTAGTACCGAATAGGAGCCGCAACACAC
Strand-Sequence-499	ACATCCAACACTCTACGCCCACCGTTCAAGAGTTCAACCTCGCGACGTTCGCCGTCGGACGCGCCTACGCCAAGTCGAACCTAAGGACTAGTACTACGAGTACGAGTTACGGAGAAGAGAGCGAAGGTAAGTAAGGTCTAGAGAACTCGTTAGACTCGAGTTCGAAGAGCGGTAGCGGTCGGTACTCGACGACTAGTAGTACGTCGAGGTCGAACGTCTAGTAAGTCCTAGAATAGGAGCCGCAACACAC
Strand-Sequence-500	ACATCCAACACTCTACGCCCTAACGCGCGTCGTTAGAGTTACCTCAAGCTACGAGGAAGAGGTTCGCGACCGTTCCTAAGACTCAAGTCCTAAGGTCGTTACGAAGGACCGCTCGGTTAGAGTCGTTCAAGTTCGTCGAAGACTAAGCTAAGAAGTCGACGAGACAAGACAACTACTCGAGACAAGCCGTTCTAGAAGACCAAGCCGGCGCGTACGTCTAGACCGTCGCCGAATAGGAGCCGCAACACAC
Strand-Sequence-501	ACATCCAACACTCTACGCCCAGAGAACCTAGACCTCGAGAGTAGAGACTAAGGAAGTTCTACGGTAAGAGCGAAGGCCTCGGCGCTCGGTAGTTACCTAGGTAGAGTAGGAGCAACAAGAGGAGATCGTAGAGCTCGTTCGAACTCGGTTAAGAGAGCGGTAGAACTACCGGTAGGTACGTCTACCTCGAAGACGTCGCCGGATCGTTACAAGAACGCCTAGAGAACGGTGAATAGGAGCCGCAACACAC
Strand-Sequence-502	ACATCCAACACTCTACGCCCTTCGCCGGTCTCGGTACGTCGGAACGCTACGCTCTCGCGACTACCGTCGGTAGAAGCAAGAGTACGTTCTCGTTACAAGAAGAACTAGAAGGTTAGTAAGAGGAAGCCAAGAGGTCGTACAAGACTCTAGACGCTAACGCCTAAGGCTAGGAAGGTAGCTACTACTACTAAGACGAAGAAGCTCTAAGTTAAGAGAGTAGGTAGAGACCTGAATAGGAGCCGCAACACAC
Strand-Sequence-503	ACATCCAACACTCTACGCCCTTACAAGAGTTCAACTACTAAGAGAAGAGAAGAGACAACGCCGCTACTAGACTAACTCAACTCCTAAGGAAGTTCGAAGGTTAGTACTACGCGAGCAACGCGTTCCTAACGAAGTACGGCTCGAACCTACGCGCGACTAGTTACGGCGTCTACCTCGCCGTACTCGGAAGGTTCAAGTAGTACGTCGCCGTTCCTAGTAGCGCTCGAGCCGAATAGGAGCCGCAACACAC
Strand-Sequence-504	ACATCCAACACTCTACGCCCGAACCTAGACCTCGATCGAGTTAAGCTACCTAACCTCGGAAGTAGAGAGAGAGTAGTTAAGGCTAAGGCAAGAACGGACTCTAGGCCTCGACGGAAGGTCGGACCGCGTACCTAAGACCTCGCTACAACGCTACGTTAAGCGAAGAGACCTCGAACTAACTAAGGAAGTACGGAGAACGCAAGAGCGCTCAACGCAACGGAAGGTAGTTCGAATAGGAGCCGCAACACAC
Strand-Sequence-505	ACATCCAACACTCTACGCCCACCGGTCTCGGTACGAGACGCTCGAGTTAGGAAGTCTACTAGAGTCTCGGTAGGAACTACTAAGTCTCGACTAGTAGGAAGACCGCGACCGTCGAAGACGTCTAGAGTCTAACGAACTCGAACGGACAACCTAGCCTCTAGACGAGAAGACAAGCGAACTAAGAGTAGACGAGCTAAGGATCGAAGTAAGGCGTCCTCGTCGAACTAGACGAATAGGAGCCGCAACACAC
Strand-Sequence-506	ACATCCAACACTCTACGCCCTAAGAGTTCAACTACCTCGAAGCGAGAGAGTTCAAGTCGAGGAGACAAGCTAGCGCCGGTCTCGGTAGGACTAGCGTCGAAGGTAGTCTAAGCGGTAGTAGGTAACGCTACCTAGAACTCCTAGACGCCGCTAGTCTAAGTAGGAACGCCGGAACTAGAACGAAGAGAAGGTTACTAAGTTACCTCGGTCGGTACTAAGACGTCTAACCTGAATAGGAGCCGCAACACAC
Strand-Sequence-507	ACATCCAACACTCTACGCCCACGTCGTTAGAGAGCCTCGGTAGCGAAGAAGTCAAGTAACCTCCTACTCTCTCGAGGACCAACGTCTCGTACGCTCTCGAACGCAAGAGACTCAAGGAAGCTCGAACTAGAAGACGCTAAGCCGCTAAGACCGGACAACAACAACGAGAGACTAGGAACCTCGGTAAGAAGACGTAACTACAAGCCTCGTAGTAACGAAGGTTAAGAACGGAATAGGAGCCGCAACACAC
Strand-Sequence-508	ACATCCAACACTCTACGCCCTACGGACCTCGATCGTTCAAGAGGACCAACGTCTACGAAGCCTACGGAAGTAAGGAACCTCGGAGGAGCGGTCTAAGGAGACGCGTCGCTACTACGTCGAGAACTAGACTAACGAACGCCGGAAGACGCTAACCTCCTAGAGACTACGCCAAGAGCTAAGCTCTACGCGAAGAAGCCGGTTCGACTAAGAAGTAAGCCAAGTAAGAAGTCGAATAGGAGCCGCAACACAC
Strand-Sequence-509	ACATCCAACACTCTACGCCCAGTCTCGGTACGAGACTACTAGAGACGTTCGAAGCCGCCTAACCTCTCGCCGGAGAGTCGTCGAAGAGACCTAGGACGAGCCTCGGATCGTCGTTCAACGCGAACTACTAAGCCGTTAGTAACCTACGACCTCGAAGGAGTTCGACTCAAGGTTCGGAACGCGGTACGTTAAGCGGACTCTACGCCAAGTAGGAAGGAACTCTCGAACGTGAATAGGAGCCGCAACACAC
Strand-Sequence-510	ACATCCAACACTCTACGCCCAAGTTCAACTACCTCTAGAACGGAGACTACAACGGACGCGGAAGGAGCAACAAGGAAGGACCTCGGTAAGCTAGACTCCTACTAACTCCTCTCGAAGAAGGAGAAGCGAACGGAAGTTACTCGTTAGAAGCCGCCGTTCGAAGCGGTCTAAGGTTAAGCGGTCTCGGTTCGACTACGTTAGAACCTCGGACCGAAGGCGAACGAGACTACGAATAGGAGCCGCAACACAC
Strand-Sequence-511	ACATCCAACACTCTACGCCCTCGTTAGAGAGCCTCGAAGACCTAAGCGAAGGTAAGAGAACCGTACGAACGACTCCTCTCTCGAAGTAGTTCGCGTCGACCAAGAGTAGCTAGAGCAACTACGGCGGTAGGACGAACTCGACTAACAACGGCTAACGACGCGAACTAAGAGAGACCGCGAACCAAGTCGCCGCGAAGTTCGCTACGTTACTACGCGCGACCGAACAAGCCGAATAGGAGCCGCAACACAC
Strand-Sequence-512	ACATCCAACACTCTACGCCCAGACCTCGATCGTTCGCTAAGTACTAGACCGGCTACGGCGTCAAGAGCGTCTACTAGAGTAGAACTCTCTACTAGAGCGAACCTAGCGGAACGTTCTAAGCTACGAGGCGGTAGACGACGAGCGAAGCCGGTCGGTAAGACTCGAACGCCGTAAGAAGCAAGTACGCGTCGTCGTACGGTAGGTAAGAGAGATCGTAAGTCGCCGGCGTAGAATAGGAGCCGCAACACAC
Strand-Sequence-513	ACATCCAACACTCTACGCCCTTCGGTACGAGACTAAGTTCGAGTCGGACGTTCTAAGCCGCTACGTCGACGAGGAGAAGTTACGGCTCGAGCTAGTAGTACGCTCCTAGTAGTAGAGAACCTAGGAGTAGGAACGGAGACAAGGAAGAGAGGTACGTCGGAGAAGTCGCGAGTTAGGAAGGTTCGTACAAGAGCTCGTAGGAAGAAGTCAAGAACGGCCTAACGAGTAGGGAATAGGAGCCGCAACACAC
Strand-Sequence-514	ACATCCAACACTCTACGCCCTTCAACTACCTCTAGAACTAAGCCAAGAGACGCTAAGGAAGCGGTAACGTCGCTAGAAGCTACGCGAGTAGTCTCGTCAACAAGACCGTACGCCTAGACGGCGTCTAGAACCTAAGCGGACAAGGAGAGTAACGAACCGAAGCTACTAGCAAGTTCGGTTACGGCGGAAGTCGGACTCTCCTACGAAGAAGGTAGAGAGAGTAGACCTAGGAATAGGAGCCGCAACACAC
Strand-Sequence-515	ACATCCAACACTCTACGCCCTTAGAGAGCCTCGAAGAGGAACTCGAAGGCAACCTACTCGGTACGACTAGACGCAAGAGTACTCAAGAAGAGTTCTACAAGAACGGAAGCCTCCTACTAACCGTTCTCGGCTACGGCGGACTCTAAGGTAACCTACTAGACGCCGAACTAAGCGCTACCGGTAGGTAGAGCCTCGTCCTAAGGTAGAACCTAACGTCGTACGGCGCTAGCGAATAGGAGCCGCAACACAC
Strand-Sequence-516	ACATCCAACACTCTACGCCCTACTCGTCGTTCGCTCGAAGCTAACCTACTAACCTAGACGTCGCCGAAGGCGCCTCGTACTCGAAGTTACGCCTACTACGCGGCGGAACCGTACTAACTACTCTCAAGACTCGGAGAGAGTTAACTCGGTTCAAGAAGTAGAGTTACGCTCAAGACCTCAAGTCGAACGCGAGGAGGTAGTAGTCGTAGTACGCTCCTCGCGGTAAGAGGGAATAGGAGCCGCAACACAC
Strand-Sequence-517	ACATCCAACACTCTACGCCCAACTACCTCTAGAACCTCGTCTCGTAAGAGACGTACTCGTAGTACCTCTACGGAAGGAGTCTAAGAGACTAGAACGTCTAAGCCGCTAGTACTCGGACCGGAGAAGGCAAGACGAACAACCTACGCTAGACTCTCAACGGATCGAGCTAGTTCGGACAAGAACTAACGTAGGAACTCCTAAGTAACAACGAACGAAGGAGACGCTACGGAGAATAGGAGCCGCAACACAC
Strand-Sequence-518	ACATCCAACACTCTACGCCCAAGAGCCTCGAAGAGTTAACTACGACTAGTAACGAACGCGGTACGACTACTCGACAAGAGACGACCAACTAGACTACTAGCGGACTAGAAGACAACTAAGCCGTACGCTACGCCGGATCGAACGGTACGGAACGATCGAAGTACTCGGAAGGCTAAGAGGAAGTCGCTAACGCGTCGTCGGAACAACCTAGGTACTACGGACTAAGGACTGAATAGGAGCCGCAACACAC
Strand-Sequence-519	ACATCCAACACTCTACGCCCTCGTCGTTCGCTCGACCTAGTTACAACGGCGCCAACGTCTAAGCTACCGGCCTAAGTTACTAACTACGAAGTACCGTTACGTACGGTAACAAGAGAGAACGAAGAAGCGAAGACCTCAACCTAAGGCGGACGAACTAGAGTCGGAGTAAGTACGGATCGACCTACGCTAGAAGAACCGGCGCTAAGACCGCGAACCTCGAAGAAGAGTCGGAATAGGAGCCGCAACACAC
Strand-Sequence-520	ACATCCAACACTCTACGCCCACGAGACTAAGTAGAAGCAAGAGTTAGGAACAAGACCTCAACGCGACCGCTACCGGTTAGTTCTACGAACGAAGAACCGAACCTACGAGAGACTCGACGACCAAGACTCTCCTAAGCAACGTCTCGAAGAGAAGTAGGTACAACGAAGAGACTCTACTCGAACTCGCCTAGAGCCTAGACTCGAGAACGAGTTAACTAACGAGGAACGGTGAATAGGAGCCGCAACACAC
Strand-Sequence-521	ACATCCAACACTCTACGCCCTACCTCTAGAACCTCGTCTCGAACTAACTAGAGTAACCTAGCGGTCTACAAGAGTCGTAAGCGTAGAGGTAGACCTAGAGAGAAGGCGTCGCCGCTCGGAACGGTAGGACGTTAACCTACTAACTCTACGGCGAACGACAAGCCGTAAGTTAAGGACCTCAACGTCTCGGTAGTTAACTCTCGAGATCGAGCTAAGTCGAACTAAGCGAAGAATAGGAGCCGCAACACAC
Strand-Sequence-522	ACATCCAACACTCTACGCCCAGCCTCGAAGAGTTAACTCGGACCGAACGAACTCGCGGAAGAAGAAGCGAAGCCGGCTACGCTCTAAGACCTACGACCGCCTAGTCGTTACGCGGCGAAGCCTCGTACGCGTAAGCGAAGAACCTACCTAAGTAGTTAAGCGTCTAGAAGAGATCGTCGTTAGAAGCTAACGCTACTCCTCCTAGACTCGCCGCCTAAGACGTTACTCCTGAATAGGAGCCGCAACACAC
Strand-Sequence-523	ACATCCAACACTCTACGCCCTCGTTCGCTCGACCTAGCGGTCTCCTAACTCGGAGTAACCTCGGCGGAAGTCTAAGAGAGTACCTACGAAGCTACGGATCGTTACTCGGCCTCGGACCTCTCTAACTAGGAGAGACCTACGCCGCCGTACCTCTAACGTTAAGTACTCCTACGACTACCTACGTCGTAAGCGGAAGTAACAAGACGGAAGACAAGAACTACGGACCTAGAGAATAGGAGCCGCAACACAC
Strand-Sequence-524	ACATCCAACACTCTACGCCCAGACTAAGTAGAAGCTCGAAGTTAAGTAGCTAACCTAGAACCGTTCGAGAGACTCGAACCGTAAGTACCGCCGCCGCTAGTTACGGACCTAACTACGGACTACTAAGACCTACGTAACGAGACTAGGAACCTAGGTACCTAAGAACCTACTACGCTCGGAACGTCAAGACCGGCCTAAGGACTCTCTAACGCGGTAGGTAAGAGAAGACGGAATAGGAGCCGCAACACAC
Strand-Sequence-525	ACATCCAACACTCTACGCCCTTCGAAGAGTTAACTCCTCAACGCTAACGCGGAGACGGTACGACGAGAAGAAGACTCTCGAGAAGTTAACAAGACCTACCTCGCGAAGTCGCCAAGTTCTAACTCTAAGCTCGAGAGAACGGTACGGAAGAGTCGTTCCTACCTACTCTACGAAGTAGTAGTCTCGGCGAAGCGTTCAAGAGCGTCGAACCTCCTCGCTCGACGAGACCTGAATAGGAGCCGCAACACAC
Strand-Sequence-526	ACATCCAACACTCTACGCCCTTAAGTAGAAGCTCGTCGTAACAAGCGGAAGACGCTACCTCGAACTCGACTAACAACTCGACGAGGACCGGTTACGGTACTAGCAACTACCTCGGTACGTTCGGCGGAGAACGCGTCTACGCCGGCAAGTAGGAAGGAACTAAGTTCGGAAGTAGGTACGCCAACGAAGGCGCCGCCGTCGCCAAGTACTACGAAGACAAGTAGCGGTAGGAATAGGAGCCGCAACACAC
Strand-Sequence-527	ACATCCAACACTCTACGCCCTAGAACCTCGTCGCGAGACAACGAGACGGAAGCTAGTAAGTCGCTACTCTAAGCGTCTCGTTCAAGTTCGCCTACGGAACTACTAACGAAGACGTCTAGAAGACTAGAAGGTTAAGTACCTAACGCGCTAACGGACTCTAGACCGAAGAACTAAGGAACGTCGTCTACTCGAACTCGTAGGAAGTCTACTACAAGACGTAGAGGAGAACTGAATAGGAGCCGCAACACAC
Strand-Sequence-528	ACATCCAACACTCTACGCCCGAAGAGTTAACTCCTCTCGAACGAAGAAGTACTCCTAACTAGAGGAGCAACTACTCGAGAGAACCTAAGTACAAGTAAGGTAGGAGCTCGAGCTAGTAACGAGACAACGGCGCCGCTAGGAACCTAACTAGGTACGCTCGAGACGGTCTAACTCGACGCCTCGGTAGCGCTCGCGCCGGCTCGAAGTAAGGCGCTAGCGAAGCGAAGAAGGAATAGGAGCCGCAACACAC
Strand-Sequence-529	ACATCCAACACTCTACGCCCACTCGACCTAGCGGCCTCGGTTCGGAAGGTACCGGCTAGTAGACTAGAACCTAGTACGTCAAGAGACTCGGTAGCGTCTCGTTCGGCCTAACTCTCCTCAACTAGTACTAACAAGAGACGACCGGTAAGAACGGCCTAAGCGGCAAGTTACCTCAAGAAGACGCCGGCGCTAGAGACGCCGTCGGTAGTACTCAACTAAGTACTCCTAGAGAATAGGAGCCGCAACACAC
Strand-Sequence-530	ACATCCAACACTCTACGCCCAGTAGAAGCTCGTCGTTCAACGCGTACGGTCTAGACAACTCGTAGAGACGCCTCTACAACGTCGTCCTACGACCTCAACGAGAAGGCAAGTAGTACGGCGTCTCGAACGGACTAGAGACTAGCGGACTCAACGGCCTAAGGAGTACTAAGACGGAAGCCGAACTCTACGTCTAAGAGTTCTACTAAGGAAGCGCCGGCAAGTTACTAACGGAATAGGAGCCGCAACACAC
Strand-Sequence-531	ACATCCAACACTCTACGCCCAACCTCGTCGCGAGACTACCTAGCGAACTACTCCTCGGCGCGGAAGTCAAGTTAACCGTCGAAGAAGGAACGGAAGCCGTTAGGAAGACCTAACCTCAAGACTACCTCTACGCCAACTAAGCGTAAGTCTCGACGACTAGTAGTTAAGAAGAGTTCGCTAAGACCGTCAACAAGAGTAGCTAGTCGAGCCTACGAGAAGCGAGTTAAGAGGAATAGGAGCCGCAACACAC
Strand-Sequence-532	ACATCCAACACTCTACGCCCAAGTTAACTCCTCTCTAGAGCGTCAAGAGCTACGGCTAGAGCCTACGACCTCGGAGGAAGGAAGACTCGACGAGAAGCTACGAACGACCTCGCAACCTCGAAGACGCCTAAGTCAACGTCAAGTACGGAACGACTAGGTTCTCGACCTAAGTCGCGAAGTCGACGACGACGAACTCGACCTACGCGAGCGCTAGAGAACCTACCTAGAAGGAATAGGAGCCGCAACACAC
Strand-Sequence-533	ACATCCAACACTCTACGCCCTCGTACGGCGGCCTCTAAGTCGCTCTCTCGTACCTAAGTAGTTCGACTCAACAACAAGTCGCTCAAGCTCGGTAGAAGACGTTAACCTAGACGTCGTAACGAACTCGGACTCAAGGTTAAGTCGTCGCGAACGGCGGCGGCTAAGCTCCTCCTAGAGAAGGAACTCGGAGTTAAGCGGAAGCGTTCGGCGTCTCTAGCTCGAGGACGGAAGAATAGGAGCCGCAACACAC
Strand-Sequence-534	ACATCCAACACTCTACGCCCTTCGTCGCGAGACTACCTAGCAACGGTTACGCGTTACCTCGGTAGTCGTACGCTAAGTAACAACTAACTACCGGCGCCGCCGCCGGCGTCGCTAGAACCTACGCGAACAAGTCGTTAACGAAGAGAAGTCTCTAAGTCTAGAGGTCGGAACAAGGTCTAGAGAGTTAAGGAAGAGAGTAGAGAACCGGCCTACTAAGGAGACAACTAAGGGAATAGGAGCCGCAACACAC
Strand-Sequence-535	ACATCCAACACTCTACGCCCTTAACTCCTCTCTAGAGCCTAACCGCTAGCGGTTACTCGAACTAAGGCTACGGACCTCGGTAAGGTTCGAGAGAGAGGACTAAGACTCTCCTCGGCGCTAAGACTACGAAGACCGTCGTCGTCTAACTACTCCTAACGACGACTCCTCGCGGAGAGAACTCGTTCGAAGAACGAGAGAAGAAGTACTACGCTCTAACTCGGAGCGTCGGTGAATAGGAGCCGCAACACAC
Strand-Sequence-536	ACATCCAACACTCTACGCCCTACGGCGGCCTCTAACGAGACCTCAACTAGAAGAGGTACGCCGGTTAACAACTAACCGTCCTAGACTACCTCAACGCCGCGAGGAGAACCTAAGACTACGCTCAAGAGTACGGCGCCAAGAGTAGTACCGGTAGGTCGACCGCCAACCTAACCGCGTTACTCGGATCGAGTAACCTAGCCGTAGTAACTACGACGAAGTACGCGAGGTTAGAATAGGAGCCGCAACACAC
Strand-Sequence-537	ACATCCAACACTCTACGCCCAGCTCGTCGTTCGCGACGTAGTAAGCGTACGGCGGCGAAGCTCCTACTAGGACGTCGTAAGAAGGTCGGTAGTTCGTCTCGACCTCGAAGAGTAAGTTCGCCAAGTTAGAGTTACAAGGCGCTCGGTTAAGGTAGTTACGCTACTACAAGAGAGAGAACAAGAGCGGTAGGAAGACGAACGCTACGAAGTTAAGTAGGACTCCTCTCTCGGAATAGGAGCCGCAACACAC
Strand-Sequence-538	ACATCCAACACTCTACGCCCACTCCTCTCTAGAGCGAACTAACGAGCAACCTCCTACGCAAGACTAGGACGTTCAAGAACGCTCTCAAGACTCGGAAGTACGGAACGAGGACTAGAGAAGCCGGCTACCTAAGTCGGACCTCGACGACGACTCAAGACTAAGAAGCCGCTCTCTCGTACGCTAGTTACTAGTTCCTAACGTAGACTAAGAACGGCTAGTAAGGCGCTCGCGAATAGGAGCCGCAACACAC
Strand-Sequence-539	ACATCCAACACTCTACGCCCAGCGGCCTCTAACGAACCTACTACCTCGGACTCGCGAGATCGTTACAAGAGTACTACGAAGCCTCGACCGCTACGACGGAACGAAGGTTAACTACGTAAGCCGCTACGAGCGCCGCCGTAGAGTCGTTCCTACGAAGACTCAAGAACCTACAACGAACTACTCGAACTAACAACGTCTACTCGACGACTAGTAGCGGCTAGAACTAAGAAGAATAGGAGCCGCAACACAC
Strand-Sequence-540	ACATCCAACACTCTACGCCCACGAGACTACCTCGCGCGTAAGAAGCCTCGACTCGGAAGAGCCTCTAGTACCTCTAACTACCTAGCGAAGCCTACAACCTCGGTTCGTTCCTCGCCGGTCTACAAGACCTCTAGAGGACTCGCGCCGGCTAGAACAACTAGTTCGAAGTCTAGTAAGAGAGTAACGAAGGTTAGTCGTTACTAACTAGTAGTACCGGTACTAACGTCGGCGAATAGGAGCCGCAACACAC
Strand-Sequence-541	ACATCCAACACTCTACGCCCTACCTCTAGAGCGAACGCGGAACTCTCGCTAGTACCAACTCGAGAGAGTAGTTCGCTCTCGAAGTCAAGTACCTCGCGTACCTACTCGCGCCTAGGAGGTAAGGTTCGTCGAAGTCGAGCTCGTTAAGGAACGTCGTCGCGGAACAAGACGCGTTCAACAAGAAGGAAGAGACGAAGAGAACGTTACCTACCGAACAACTCGCGAGGTAAGAATAGGAGCCGCAACACAC
Strand-Sequence-542	ACATCCAACACTCTACGCCCTCGTTCGCGACGTAAGCTAGCCTCGTCTAGACGAGCAACGGAGAAGGCGTCGTCTAACTACGCGAAGCGAGACAACTACTAGAAGGAAGGACCTACAACGGTAAGGAACGAACCTAAGGTAACGGACAACCTACGAGAACCGAAGAACGACAAGCGGAACTCTCGAACGGTACGACCGTAAGGCGGTCGACCGAACTCGGAGACGCTAGCGAATAGGAGCCGCAACACAC
Strand-Sequence-543	ACATCCAACACTCTACGCCCAGACTACCTCGCGCGAGCTCGTTAACTAACGCGTAACGACCTACGAGGAGCGTCTCGAGGCGGTTCGCTAGCCTCGGTACCGCCGAAGGTTAGAGCAAGTAGTACGGTAGTAGGTAACAAGACGTCCTCGGCTAGAAGACTCGGTTCTCGTAAGAAGGTAGACAAGCGACTAACGTCCTCCTAGACCGTCTAGAAGGTCGTAGACGCAAGGAATAGGAGCCGCAACACAC
Strand-Sequence-544	ACATCCAACACTCTACGCCCTTCTAACGAACCGAAGCTCGACGCGGTTCGGAACTACGAAGCGGAAGTACTACTCAAGAAGAGGAAGCGAGCTACAACAACGGTTCGTTCAACGCTCCTCGCCTACTCGGCTACGAACCTAGCTCGACTAGAAGGACTACTCGCTACAAGTCGAAGTTCGCCAACTAGAGTTCGAAGAGGTTCTAGACTCGACTCGAAGCTAGCGGACTAGAATAGGAGCCGCAACACAC
Strand-Sequence-545	ACATCCAACACTCTACGCCCTTCGCGACGTAAGCTAGTTAACTCTAAGGAAGGAGACAACTACGAGACCTACAAGAACGCGGCTCGTTCTCGAACAACGCCGTAACGTTAGACGGTAGCGGACAACCTCGGTAAGTCGCCTAACAAGAGAGTTACGGTTCGACGAGGTTAACCGGTACCGGTCGGAACGGTCTAGAGTACTAGAGATCGAGCGCTAGGTTACGCTACCTAGAATAGGAGCCGCAACACAC
Strand-Sequence-546	ACATCCAACACTCTACGCCCTTACCTCGCGCGAGCAAGTAACAAGCGAGGACCTCGTAGAGCCTAAGAGAGACTCAACTAACTAGTCTAAGTAAGAACGAAGGCGTCAACGTCTCGAGCTACTCGACCGCGAGTACTCGGACGTACGCCGTTAAGAGTTACTCGTTAGACTACGTCGGAAGTAAGAGACAACTACTCAAGACGACGTTCGCCTAGACTCGAGACTAAGGTGAATAGGAGCCGCAACACAC
Strand-Sequence-547	ACATCCAACACTCTACGCCCTAGAGCGAACGCGTCTCGTAACGACAAGCGAACAAGTAGAGCTAGACGTAAGGAAGTAACGGAACCTAGAAGAGTCTAACGTAAGCTAGTACGTACCTCGTCGCGACCTACCTCGGCAACGCGACCTCGACCGCCGTTCGGACCTCGGCCAAGTTACCTCCTCGGAGTAACTCGTTACTAAGCTAAGGAAGAAGTCTCGAAGTCAACCTAGAATAGGAGCCGCAACACAC
Strand-Sequence-548	ACATCCAACACTCTACGCCCTAACGAACCGAAGCTAGAGAACGACCTAGCCTCTAGTTAAGTTAAGGAAGTTAGAGTTACAACGGTCTCTAGACGAACGAACGAAGGAGTAGCGTCAAGGAAGGCCTAACTACCAACTACGGATCGAGCCTCCGCCTCGGTTACGGAAGACAAGCCGCGTTAAGTACCGTTCGCGTCTAGAGTACTCAAGACGGAAGCGCGAAGACCTACGAATAGGAGCCGCAACACAC
Strand-Sequence-549	ACATCCAACACTCTACGCCCACGACGTAAGCTAGTCTCGGTTCGGAAGAAGGCGAAGGTCTCGAAGACGGTAGTCTCGGACAACTAACCTAACTACTCAACGCCGCCGGAAGCGAAGAGTTCCTCTAACTCGCCGCCGTTCGACGCGCGTACGAAGTCTAAGCCTACAACGAACCTAGACGCGGCGGTAGGAAGACCGTCTAGACCAAGAGGTTCTCCGTAACTACTAGTGAATAGGAGCCGCAACACAC
Strand-Sequence-550	ACATCCAACACTCTACGCCCTACTAGACGAGCAAGTTCAACGCGACGTAGAAGACCGGACGCTAAGCGGAAGGAAGTAGTAGGTAGTACGTCGGCGGAAGACCTACTCGATCGACGTCGTTCCTCTACGAACTAACGACCGTCGCTAGCCTCAAGTACGCGAGGCGGCGGTCGTACTACTACAAGAAGAGGACTAGTCGGAACGCGTACGAACGTAGAAGCGGTAGACAAGAATAGGAGCCGCAACACAC
Strand-Sequence-551	ACATCCAACACTCTACGCCCAGCGAACGCGTCTCGTTACCTAGCCTAAGGTAACTCGTCGGAACCAACTAAGAGGAACGCGCCGCCGGAGAACGAACTCTCCTCCTAAGTTCGAGTTAACCTAGGACCTACTAGTTAGACGCCTAAGCTCAAGAGTAAGAAGGTCTAGAACTAACCGGTCTACCTACGAAGAGTAGACCTAACTACAAGTACGCCGTACTCGCCTCGTCGGAATAGGAGCCGCAACACAC
Strand-Sequence-552	ACATCCAACACTCTACGCCCTCGACCGAAGCTAGACGCGCCGGAACTCCTCAAGAGAGAACCGGTCTCGGTCGGACGTCGACCGCGGAAGGTAGGACGACGAAGAGTAAGTAGGAACAAGACTAACGAACTCGGAGAGACGTCGAACCTCGGTAACGATCGAGACTACAAGAAGAACTCGGTTCGAAGAGCCTCGCCGTAAGGAAGTTCAACTAGTTACTCGGTCGTACCGAATAGGAGCCGCAACACAC
Strand-Sequence-553	ACATCCAACACTCTACGCCCACGTAAGCTAGTCTCGAAGAACTAAGGAGAACGGAACCTACTCTAACCGTAACTCTACAACTCCTCCTCCTCGAACGCGGACAACCTAGTCTACTCCTACCTACTAAGAACCAACTCGGTACCGCTCGGCGGAGGAGCGGTCTCGGCGTCGCCGCTCCTCGATCGTAAGCTAGGCCGAGTTAGTTCGCCGTAAGCGTAGTAAGCCTCAAGGAATAGGAGCCGCAACACAC
Strand-Sequence-554	ACATCCAACACTCTACGCCCTAGACGAGCAAGTTCGCCGCCTACTAGTCGGAAGCGAGGCGGTTAAGAAGTCTCGTCGGAACCTAAGGCCTAGAACGAAGTTAGTACAAGAAGGAAGTCGGAACGAGAAGACTCTAACTAAGGTTCTACAACGCTCGCTAGTTAAGTAGTTCGAGGACCGGTAGACTCGAAGGTACGTTAACTAACCTCCTAAGAAGAACCGTCCTCTCGGAATAGGAGCCGCAACACAC
Strand-Sequence-555	ACATCCAACACTCTACGCCCGAACGCGTCTCGTTAGAAGGACGCGAAGAGAGCGAACAAGCGGAAGCGTAAGAGGAACGACGCGGTTAAGGCCTAACGAACGCCAAGTTACCTCGCTAGTACGGAGACTAAGTCGGCGAAGAGTAGTTACGCTCGACCGTCTCGACTAGACTAAGGTTCTAGACTACCTAGACGTACTCGAGAGAAGGCGGCGCCTACGAAGGCAACTAGGAATAGGAGCCGCAACACAC
Strand-Sequence-556	ACATCCAACACTCTACGCCCACCGAAGCTAGACGCGCTCGACTCCTCGCCGTACCTCGACAACCTAAGTAGAGCTACCTCCTCTACTAAGGACTACCTAGCGGAACCGTAACGACCTAGTAACGAAGTACTAGTTAGTAGGAAGGAGAGGAAGAAGCGGAACGCAAGACTACGAAGTCGACGTAAGCCGCTAGTTAGGAACTACTAACGTACGTCAAGAGGACCTCGTAAGAATAGGAGCCGCAACACAC
Strand-Sequence-557	ACATCCAACACTCTACGCCCTAAGCTAGTCTCGAAGGTAGACTACTAACCTAGAAGTAACTCTAAGACTACGCTACTCCTCGCGGTTAAGAAGCCGCTCGCGCTAGGAGAAGCGAAGACGTCTCGACGACTAGCAAGAACCTCCTCGCCAAGAGAAGTTCGTAGGAACCTCGCGCGTTCGCCTCGACGTCGTAAGCGGAACGCGGATCGAACGTCGTCTAGAACGGAGAAGAATAGGAGCCGCAACACAC
Strand-Sequence-558	ACATCCAACACTCTACGCCCTAGAGGTCGTTAGAAGACGGAAGGCGGACTCGAAGTAGTCTAAGAGACGCTCGAGAAGGTAGTTACGGAGACTAGAGGAGGACCGTAGAACTAAGGAGCCTCGGCGCTAGTTACTAGAGGAGTCGGACCGCTAACCTCGTCTACCTACTCCTAAGTTACTAAGCGTCGACCGTCGAAGCCGGTCTAACTCGACTCAACGAAGTCTACTAAGAATAGGAGCCGCAACACAC
Strand-Sequence-559	ACATCCAACACTCTACGCCCGAAGCTAGACGCGCTAACGTCAAGAGTAAGTACGCTAGTAGAGAAGGCCTCGGACGCGCTAGAAGCGCCTACCTACAAGGAGACGCTAGGAGAACGTTAACCGTTCGGAGACTAAGCAAGTTCGTCGGAAGTACTCAACTAAGGTACGGAAGCTAAGGTAACGCCGCCTACGCGAAGAGAGAACGACAAGGTAAGGAAGGTAGAACGAGAGAATAGGAGCCGCAACACAC
Strand-Sequence-560	ACATCCAACACTCTACGCCCACTAGTCTCGAAGGTAACGGTAGACTACTACTAGAAGCCGAAGAAGAACTAACCTAGTAACGAACCTAAGGTCTCTAACAAGGTTCGTTAGAAGGAAGCAAGACGTACGCCGCGAGTCGGAGTTAGAGGACTACGAGACGCGCTACCGCTCGACGCGTCGCTCAAGCTCTACTCGGCAACGCCGTTACCAAGACTACTAACCTCTAGAAGGAATAGGAGCCGCAACACAC
Strand-Sequence-561	ACATCCAACACTCTACGCCCAGCAAGTTCGCCAACAAGAACCTAGACGGAACCGTAAGTCTAAGAGAAGCGTAAGACGCTAGAGAAGGCGCCGGATCGACCGTTAGTCGGACGAGTCTCGTCGCGTTAGAAGCGAAGTTAACTAGTCGGAGGACCGTTCCTCCTAAGACCGCTAGTAGCGGACTCGCTACGAAGAGAGGCTCGAGTTCGTCGAAGAGAACCGTACAAGAGGAATAGGAGCCGCAACACAC
Strand-Sequence-562	ACATCCAACACTCTACGCCCAGGTCGTTAGAAGACGTCTAGAGCGCTACTCAACGCAACTAGACTCGAAGCTCGTAGAGTCGGAGACGCGTCAAGAGGAGTAACGTCCTAGAACGCTCGAGAACCTAGAGGAGCGGAACGTCGAGGTCGAACCTCGGACTCAACGTCAACCTCAAGTTAGACGCTCGGAGGCGGACCTAGTCGAGCGTCAAGTTAAGTACTAGGAACGCTGAATAGGAGCCGCAACACAC
Strand-Sequence-563	ACATCCAACACTCTACGCCCAGTCTCGAAGGTAACTAAGCGACTCTCCTAACGAGCGTCTCGACTCTAGAACTAACTCTAAGGAAGACGAGGTTAAGGTCGTAGTAAGACGCTCAAGCGTAACAACTCCTAACCAACTAGAGTACTACCAAGAACTACTAACCTAGCGCCGGAGAGTTAGACTAGTAAGGCTAAGCGGAAGACAAGAGTACGAAGTAACAAGAAGCGACTGAATAGGAGCCGCAACACAC
Strand-Sequence-564	ACATCCAACACTCTACGCCCAAGTTCGCCAACAAGACGAACTAGTAACTAGAACTCTACGGACTAGAACCTACTCTAGACGGCGGCTACTACGCCAACGGACTACTCTAAGTCAACTCGTTCGTCTCGTTCCTACCTCTCAACGGACTCTACTACGGCGAACGACGCGCGAGCGTCAACTACGGTACTAGAAGGAGTAGACCTCGCTAACTAAGAAGTTACGAAGAAGGTGAATAGGAGCCGCAACACAC
Strand-Sequence-565	ACATCCAACACTCTACGCCCTCGTTAGAAGACGTCTACAAGGAAGCGTCGAGACCTAAGTAGTAAGCTAAGTAAGGAGAAGGTTACTAACGCGTCTACGGAACTACTAGGAAGAACGCCTCGTAACGAGACTCGTAACTACGACTCGGTTACGGTACGTTACGCCTAGAAGTCAACAACAACAAGTTACTACCTCCTCGAGAACGAGAAGTCGCGGAAGGACGCTCTCCTGAATAGGAGCCGCAACACAC
Strand-Sequence-566	ACATCCAACACTCTACGCCCAGACGCGCTAACGCCGGTTCGACTCGAGAGTAAGGAAGGAGGTTACGAACCGCTACGTAGTAGAACGGAACCGAAGCTAGTAAGTTACCTACCGAAGCGGAACTCTAACTCTAAGGAGAACGCGCTAGCTACGCGTCGAGGAGCTCGTAACAACTAGACGGCGGTCGGAGTTCGAGCGAAGGTACCTAACAAGTCCTCTAGAACTAGACCGAATAGGAGCCGCAACACAC
Strand-Sequence-567	ACATCCAACACTCTACGCCCTTCGAAGGTAACTAAGACGCGAGTCTCAACAAGAGCCTACTAGACTAAGCTCGGAGTAGCGCGTCGTACGGAGAAGACCTAACCGCTACGTAGACCGCCGTCGGCGTCGTCTCGACGTAAGGTCTAGAGTAAGAAGCGAGACGCTCGACCGGCGCGTTACAACAAGCCGGCAAGGAAGGTAGGAAGACCTCTACTAAGGCGAAGACTCTAGAATAGGAGCCGCAACACAC
Strand-Sequence-568	ACATCCAACACTCTACGCCCTTCGCCAACAAGACGAACAAGACCGGCTACAAGAGTAGACTACCTCTCAACTAAGACGCCTAAGTCGGAGAGAGGAGGACGACCGCGTTCAAGAGTCTCTCGAAGTAGAGGAGTACTAACGTCTCGGAAGAACGCTACGGAAGCCTCGCTCAACCTAGCGTCGCCGCGTAGTAAGGAGAAGAAGCGTTCTCGTTCGTCGGTTCGTTAGAAGAATAGGAGCCGCAACACAC
Strand-Sequence-569	ACATCCAACACTCTACGCCCTTAGAAGACGTCTACAACCTACTCGGCGGCGTCTAAGGTAGGTAACAAGGCTCGTTCGGAAGGTAGTCGTCGTAGACCAACTCGAAGAGCGGCGCTCTCTAACGCCTCGGTAGCTACAACGGTTCGACTACTAGGAGCGCGACTCGAACTAAGAGAAGCGCGAGGAGGTAACGCTAGAGCTAAGTCGGAGAACTAACGTAACTACTAAGCGAATAGGAGCCGCAACACAC
Strand-Sequence-570	ACATCCAACACTCTACGCCCTAGACTAACGCCGGTAAGAAGTAAGCCGCTCGACGCCTAGAACGACTACGCGGAGACCTCGGCCTCTAGTAAGAGACGAGGAACCTCGTCGCGAGCGAAGAACAAGTCTACTAGTCGAGCGCCGTTCTAGACGAAGGCCTAAGAACGACGACCGTCTAGAGTTAAGGCTAACTAGAAGCCAACGGATCGTTAAGCTAAGGACAAGCTCCTGAATAGGAGCCGCAACACAC
Strand-Sequence-571	ACATCCAACACTCTACGCCCGAAGGTAACTAAGACGTCCTCTCGTAGGAAGCGACCTAGAACCAAGACCTCTAACTCGGAACTAGAACCTAGTTCGTCGAAGGAGACGAACAACGCGTCGGTAGGACGTTACTCGCTAGCTAGAACGTCAAGTTCAAGAGAACCGGCGAAGCGTACGTCGCCGCCGTCGGTTAACGAACGAGTTAAGGTACTAGTAGGTACTACTAGAGCGAATAGGAGCCGCAACACAC
Strand-Sequence-572	ACATCCAACACTCTACGCCCACCAACAAGACGAACGCCGTCTCGAAGGAACGACTAGACGCCGGTCGGAGAAGCGGAACCGTAGAGTTACCTAAGACGACCGCGTAAGACTACAAGAGGAACTCGTTCGCCGGACAAGAGAGGTACGTCCTACAAGCCGAAGAGTAGAGTAGGAGACAACTCGGAGAGTTCTCGACGAAGTACTACCTCGCTCTCGTCCTCCTAAGCTCGGAATAGGAGCCGCAACACAC
Strand-Sequence-573	ACATCCAACACTCTACGCCCGAAGACGTCTACAACGAAGCTACGACTACCAAGAACGTCGAACTAGACGAAGCGTACTACCTCGCTAACGGTAGAGAAGCGACGAGCAACTACGCCAAGTCGTTACTCGCTCAACGAGGCGGACCTCGGCGGACGAGTAGGTACAAGAGGAGCGCCAAGTAACCTAGACCTAGAACTCCTACGACCTAAGACAAGTACTAGGAAGCCGTAGAATAGGAGCCGCAACACAC
Strand-Sequence-574	ACATCCAACACTCTACGCCCACTAACGCCGGTAAGACTACTAGCAACAACTACCTCGCCGTAACCTACTCGAAGTAGAAGTAGTAACTACTAAGGTCGTCGAACTAAGAGTACCTACAAGAGAGTAAGACCGCTCGAGAACGCCTACCTACGGAAGACTAGTCGTCGAAGAAGTTAGAAGGCTACTAGAACAAGTTCGGTAGCGAAGTCGGTAGTAACGGTTAGAACGGTGAATAGGAGCCGCAACACAC
Strand-Sequence-575	ACATCCAACACTCTACGCCCAGTAACTAAGACGTCGGTAGCGTCGGACGCGTCCTCCTCGAAGACGGTAGTTCGTCGAGGTTAAGGACTAGAACCGCCGGTAGTCGGTACAACGGCGGTTACGCCGGAACTCGCGCCGAAGGAAGCGGTTAAGAAGAAGACGCCGTTCGCCTCGGCCTCAACTACAAGAGGTAACGTTACTAACAACCGAGAGAACGAAGACTAAGAACTGAATAGGAGCCGCAACACAC
Strand-Sequence-576	ACATCCAACACTCTACGCCCAACAAGACGAACGCCAAGTTAGAGTAGAGCGCTCAAGCGGAAGACGGCTACTAAGCTAGGTAACGAACGTAAGCTAACAAGAGGTCGAGCGCGGAAGGACTAAGGCGGAGGTCGAGGACCGGTAACTAAGCTCGCCTACTAGAAGGCGCCGTCCTACAACTAAGGACGTACAACTCGAGAACCGTCGGACAAGGCGCCGGTACGTACTACGAATAGGAGCCGCAACACAC
Strand-Sequence-577	ACATCCAACACTCTACGCCCAACGTCTACAACGAACGACCTAGGAGAGAAGAAGGAACTCGACTCCTCGCGGAACAAGACAACTCGAGAGACAACGTCGTCGGCAAGAACAAGTAGTAAGGATCGAAGTAACTACGAAGACTCGCGTAAGGTACCTCGACTAGGACCGTACGCTAGAGTAGCGCGTTACGAAGGACGGAACCTAGTACTAACGCTCAACGCGCCTCGACGGAATAGGAGCCGCAACACAC
Strand-Sequence-578	ACATCCAACACTCTACGCCCAACGCCGGTAAGACTAGAAGTACTACGAGGACTCGCTACGTCGAAGGCGTCTCGTAAGCTACCGTTCGGAAGAGCGAAGGACTCTACGCGAGTCTAAGTTCGTTCTCGAGTTCGAGGAGGTCGTTCGGCTACAAGCCTCCTCAAGCGAACGGTAACCTCGTCGCGAGTAGCTAAGAGACCGTACAAGAGTACGCGTTCAAGAAGAACCTAGAATAGGAGCCGCAACACAC
Strand-Sequence-579	ACATCCAACACTCTACGCCCAACTAAGACGTCGGTCTCAACGGTAACCTCGGCGCCTACGAAGGACAACGAACTAACGCTAACTAACAACCTACTCTAAGACCTCGAGAGAGCTACAACGGAAGCGCTCTCAAGGAAGACAAGTACGAAGTCTAAGAGGAAGACTACGCTCGAGAGAGAAGGAAGACCGCCGGTAAGTCGTTCGTCGAACTAGAGTTCAACTAGACTAGAGAATAGGAGCCGCAACACAC
Strand-Sequence-580	ACATCCAACACTCTACGCCCAAGACGAACGCCAAGTTAGAGAACGGTAGGTTACTCGCTCTCTCGTTCTACGTCTACGGCAAGGAAGACGGAGACGGTAGTAAGTTCTACGGTCGGCGGTACAACGCTCGCGCGACCGAAGCGAGGACGAGTACTAGAACCTCGTTCGGCGCCTCCGTAAGAAGTAACCTAAGTACGAGTCTACGCGCCGTACGGTAGACGTACGTAGAAGAATAGGAGCCGCAACACAC
Strand-Sequence-581	ACATCCAACACTCTACGCCCAGGTACAACGAACGACCTAGGAACTACGGAGACGGAACCGTCTCGTTCGGAAGTACGACTACCGAACAAGGACGCCTCTCGAGACGCGTCTCGAGCGGCGCCTCGAACTAAGCCGTTCTCCTAACGAAGAGTCGGTACGCTAGTTAAGACGGCCTACGACCTACTCGGAAGAACTACGCCAAGTAGAGTAGACCTAACGGTAGCTAGTTAGAATAGGAGCCGCAACACAC
Strand-Sequence-582	ACATCCAACACTCTACGCCCACCGGTAAGACTAGAAGTACTAACGAAGTCGGAACCGAAGAGGAAGAGAAGAGCCTACTACCTCTACCTACTAACTAGGAAGACGTCAACGTCAACGGCGGTTAACGAGACGCCGGAAGCGGAAGACCTACTAGACTACAACAAGCCTAGTTACGAAGCTAGTAGTAAGGTACTCGCGGAAGCAACGTCGCCTAGAACGCGAACGGACCTGAATAGGAGCCGCAACACAC
Strand-Sequence-583	ACATCCAACACTCTACGCCCTAAGACGTCGGTCTCAACGGTAACAACTACTAGAAGAGTAGGTCGTAGAGCGCTCGAGAACCTAGTAGCTACGGAGACTCGACGACGAGATCGACGGAACTCGCTCGGAGTCGGACTAGTACTCAAGTCTAGAGAAGTCTAGACTAGAAGAGCAACTAGTTCGAACAACTACCTAGAGAGTCGACCGGCTACTCGAACTCGTAACAAGCTGAATAGGAGCCGCAACACAC
Strand-Sequence-584	ACATCCAACACTCTACGCCCACGAACGCCAAGTTAGAGTACGCCTACGTCGCCAAGACGTACTAGAAGAAGTAAGAAGGCGTCTCGTAGAACTCGTACGGCCTCCTCGCTACCGGCGTCCTCAACTACAAGACCAACAACAAGAGTTACTAAGAGACCTCGAAGAGGAAGTTCGGCGGCCTCTCGTACCGTTACGCGTAGAGTACCGCGACGACCGGTAGAGACTCGACTGAATAGGAGCCGCAACACAC
Strand-Sequence-585	ACATCCAACACTCTACGCCCTACAACGAACGACCTCGAAGTCGGTTCAACGCTAACGAACGCAAGACGACTAAGAGTAGGCGGAGAAGCGAAGGACCTAGGAACCTAAGGAGAGAACGCGCCAAGACGAGCTAGTTAAGCTAACTCAAGAGTACGTTCGTCGTCGAAGGTAGTAGGAGCGAACGGAGGAGTACTAGCGGAGACTCGAGGAGAACGACTACTCTCGCTAGTGAATAGGAGCCGCAACACAC
Strand-Sequence-586	ACATCCAACACTCTACGCCCAGTAAGACTAGAAGTAGACGCAAGTTCCTAACTACCGCCGGACTAAGGTTCTAGAGCAACGAAGCCTACGCGAACGAACGCAACGGTACTCAAGCGTTCGTCGCTACCTACGGCTCGAGTACCGTAAGAAGAGAGAGTTCGACTCCTACCGCTCAAGAGACCGAACGCTACAAGACCTCGTCGTAACGAGAAGACTAAGCTACCTAGAAGGAATAGGAGCCGCAACACAC
Strand-Sequence-587	ACATCCAACACTCTACGCCCAACGCCAAGTTAGAGTTACCTCTACTCGAACGACCTCGGACTACGTAAGGCGCCTCGTAAGAAGCGACCGAAGCTACTCAAGAAGAGTTAGAAGGCGGACTCAAGAGAAGTTACTAAGGACCTCCTAGTAAGTTCAAGTCGTAGTTAGACAACGGTAGCGCTAGGAACGCTCGACCTAAGTCGACTAGAGACGCTCGAACCGCTAGTACGGAATAGGAGCCGCAACACAC
Strand-Sequence-588	ACATCCAACACTCTACGCCCAACGAACGACCTCGACGCGGCTACTAACCTAGGAGCAAGACCGGCCTCGGCGAAGCTCGGTAAGAGTTACTACCTACTACCGCCTAGAACTAAGCTACCTCGACCAACGAACAAGAACCTCTACCTACGAGTACTAGGACCTAGTACTAACTACCTCAAGACTCGTAGTAAGACGTCAAGAGTACGAGGTTCTACGGCTACGCCGTACGAGAATAGGAGCCGCAACACAC
Strand-Sequence-589	ACATCCAACACTCTACGCCCAAGACTAGAAGTAGACAACGAAGTCTAACCGGTCGGCGGTCGAGAAGCTACTACCTAGAGTAGAGACAACGCTAGTTAGAAGACCTCGGTACCGCGAGCTAGTCGGAAGGACAACGATCGTTCGCGTACGTCGCGTTAACGTCGTACTAAGACTAAGACGGACTCGGAGACTACTCGTACCTCCTAGAGAGTAGACTAGAGTACGCCGTAGAATAGGAGCCGCAACACAC
Strand-Sequence-590	ACATCCAACACTCTACGCCCAGGAGTCTCAACCTCGCGAGAGACTAGACGAGGAGTAGGAGCTAACTACGCGCCGGACTCGCGTTCAAGTTACTCGGTACCGCCTAGTCGAGAGTTAACAACCTCGGAAGCGCCGAACTAAGTAGCGGCGCTAACGGCGAAGAAGCCGAAGCCGTCTAGACGGAAGAACCTCTCTAACGATCGAAGAGAGAAGCTACGTAAGGTTCTCGAGAATAGGAGCCGCAACACAC
Strand-Sequence-591	ACATCCAACACTCTACGCCCACCAAGTTAGAGTTACCTCTAGACGCCAAGAAGTTAACGTAAGACGGTAGGAGGAGAAGGCGGTCGACCGTCAAGAGCGGCAACGCGAGGAGGAACAACTAAGCTAGCAACGAAGCTCAAGGTAGTTAGAGCGTCGGAAGTCTCCTACGAGAACTCGGCAACTCGGAAGCGGAACAACTCGTTCGAACTAGTCGGTTAAGCAAGGAAGGAGAATAGGAGCCGCAACACAC
Strand-Sequence-592	ACATCCAACACTCTACGCCCGAACGACCTCGACGCGGCTACAACGGCTAAGAGTTAGAGTTCGCGACGAGCTACTAGTACTAGAGGAGTCTACTACCTAAGAGCGAACTCTAAGAAGTCCTACGCGAACGCTCGTCGACGAGAAGTACCGGCTCGAAGTTAAGAACGTCGTAAGCCTCGACCGAACGAGAAGGAACCGCGGAAGCGAACTCGTACCTCGAAGACCTAACTGAATAGGAGCCGCAACACAC
Strand-Sequence-593	ACATCCAACACTCTACGCCCACTAGAAGTAGACAACGAACTACCTAGTAGAAGTTCTAGACTCTCTACGCCTAACGCGCGAGTAAGAGTAAGAACGTCTAGAGTCTCGAACGCGAAGCCTAAGGCTAGACTAGGACTAGTAACGGCTAAGTCGGCAACGCCGCTAGAGTTAACTCGTTCTACAACGGCCTAACCAACGGTACCGGAAGAAGGACCGCCGGTACGAGTTAAGAATAGGAGCCGCAACACAC
Strand-Sequence-594	ACATCCAACACTCTACGCCCAGTCTCAACCTCGCGACGAGTCGGTAACTAAGTCGGTAGAGAGAAGCTCGATCGTAAGGTCTAGACCTCTCGTAAGCTAGGAGGAGTTCGAGAAGTTAGAGTTAGACGAGTAAGAGAGAGAGGTACTAAGCGTACTAGAGCGCGAGGTCGTTACCTCAAGGTCTAAGAAGGTAGTCGTAAGCGAGTCTACGCGGCCTCGCGTACAAGAAGGAATAGGAGCCGCAACACAC
Strand-Sequence-595	ACATCCAACACTCTACGCCCAAGTTAGAGTTACCTCGCTAGAAGAGACAAGAGAGTTAACGCGCGTTAACCGGCTCGAGTAGGTTAGAGAGCGGTACGGAAGCCAAGAGTTAAGGTCTCGGCGCGAGCCTAGAACGAAGCTAACTCTAGGAAGACAACGGACGCGCGTTCGGCCTCGGAACCTAGTCGACGAGACGCGTAAGAACGTCGTCGACTAGTCTCGCTCGAACCGAATAGGAGCCGCAACACAC
Strand-Sequence-596	ACATCCAACACTCTACGCCCTCGTACTCGTAGAGCTAAGAAGTCCTAAGGAGTAACGGCTACCTCGGCAAGTACGCTCGCGTCGGCGGCCTAAGTTCGAGTCTCGGAGAGAGAAGGAGACTACAAGTCTACGCGAAGTTAACTAACAAGTCGTAAGGCCTCTAGAGTCTACGACGCAACTAGAGATCGTTCGCGAGTAGGAACAAGAACTCGTTCTAAGTCCTACAACAAGAATAGGAGCCGCAACACAC
Strand-Sequence-597	ACATCCAACACTCTACGCCCAGAAGTAGACAACGAAGAACTACTCGGTCGTAAGTCGGACTACAAGGACGCGTCTAAGACAACAACTACCGACAAGACTACCTCCTCTAGTAAGCGTAACAACGCTCGTAACAAGGCGCTAGTAGTTCGTACGGCTAAGCCGTACGAAGTACGGAAGTCAACCTAGAGTTACTCCTCTAAGAGGAAGCGTTACGCCTCTCGACGAAGGACGAATAGGAGCCGCAACACAC
Strand-Sequence-598	ACATCCAACACTCTACGCCCTTCAACCTCGCGACGTTAAGTAGTTAACGCGTCGGAAGAAGTTACAAGACTCGACAAGTCCTAAGTACGGAAGGCCTCGTCAACGCTAACGCGACTCTCAACTCGTACGAACAACGAAGTAGCTAACTAACCGCTCGGAACGGCTCGTACGGTAGGAGACTAGAGAAGACCGTTCTCGAACTCAAGTCGGAACTACGAAGAACCGCGAAGGAATAGGAGCCGCAACACAC
Strand-Sequence-599	ACATCCAACACTCTACGCCCTTAGAGTTACCTCGCTAGTAGACCGTTAGCGGACTAAGTCTAAGTTAGAGGTTCGAAGGTTCGTTAAGCGAACTACGCGCCGGCTACCTACTCTCGAACGGAGACGCGAAGAGCGCTCGGTTAGACGCTAGCAACAACGGTTAGTAGTTCGTCGGAGACGCCGGTAGGAAGAAGTCGAACCTCAAGTAGGAACGAAGTCTCGTCCTCGTCGAATAGGAGCCGCAACACAC
Strand-Sequence-600	ACATCCAACACTCTACGCCCTACTCGTAGAGCTAACAAGCGTTCGCTAGGTTAAGAGAGTTAAGCTACGCCGTCGCTAACTACGGCAAGAGGAGTCTCGGCGGTTACCTACTCTCGAGCGAAGAACTAACCGCTCTACGAGACGGTAAGTAACTACTACCTAGGTCGTCGGAACGCCTCGGTTAAGTCTCGAAGTCGAGCGTCCTACAAGCCGAACTCGCCAACAACCTAGAATAGGAGCCGCAACACAC
Strand-Sequence-601	ACATCCAACACTCTACGCCCAGTAGACAACGAAGAACGAAGTAAGGTCTACCTCTCGCCTCGAGCGGCGCTCCTCGAAGAGAGAGGCGGAGCCTAACTCCTAGGACGACGAGTAACTAAGCTCTCCTCGTCAAGAACCTCTAAGAAGTCGTCGGTACTCGACAAGACAAGTAAGGACTCAACTACGCGAACAAGAGATCGAGGTTCGCTAGTACCGGTTACTAAGGCGCGGAATAGGAGCCGCAACACAC
Strand-Sequence-602	ACATCCAACACTCTACGCCCAAGTTACCTCGCTAGAGCCTAACGAGGAACAAGACTAGAACGTAGAGCTAAGGTTCGTTCCTCAAGACTCCTCGGACGTCGACCGGACTCTCGTAGTAAGGCTAAGCTCCTACGACGAAGAACGGACTCCTCTAAGGTAGTAGGTACGCTACGAGAACCTCGTAAGAAGACTAACTCAAGTCGAGTAGTAACGGCGTCAACCTCGCGAAGGAATAGGAGCCGCAACACAC
Strand-Sequence-603	ACATCCAACACTCTACGCCCTCGTAGAGCTAACAACGACCTCCTCCTAAGACTAACGTCCTCAAGACCGCCTCGAGTACCGTAACGGAAGAGAGTTAAGGACTAACCGGAACCTAACGAACTAACAACCTCTAAGCTCGGAAGTACCTACGCTAGTCGACCAACAAGTAGACCAAGAGAGACGGTTCGTTCTCGTAGTACTCGTTAAGCTCGTACCTACAAGAAGAAGCTGAATAGGAGCCGCAACACAC
Strand-Sequence-604	ACATCCAACACTCTACGCCCTTCGCGACGTTACCTCTCTCGAACCTACGCAACAAGTCGACGTAAGAGAAGGAACAAGAGTTCGCGTAACCTAGGAGGAGGAGCGTCGGTAGACAAGCCGGAAGGTACGAAGGAAGGACTACGAGTAGCGCGACGTTCGGAAGTACCTACAACGAAGAACGACAAGGACTCTAGAGCGCTAGGTACCTAGAGAGAGAAGAGGAAGTCGTCGAATAGGAGCCGCAACACAC