//Oligo Name	Base Sequence
Strand-1	ACATCCAACACTCTACGCCCAACAACAACAACAACGACGAAGAAGGTTAGTTAAGAAGAACCTAAGTCGCTCGGAGAAGACTAGAAGACGCGTCGTAGAAGTAAGGTACCGGACGCGCTCGCGCGACTCAAGACCTACAACGCTAAGCCGCCTCGACTAACGCGAGTCGGACTCGCAAGAAGACGTAGGAAGGCGGTCGGTAACTACAACGAAGTACCTAGTTCAACGGCGAATAGGAGCCGCAACACAC
Strand-2	ACATCCAACACTCTACGCCCAACAACAACAACAACGTCGAAGGTTCGTACGTCGAACAAGAAGACTACTAGTTCGGTTCGAGTACGAGAAGACGCCTCTAGAGCTACGGTCTCTAACTACCTAGTACGAGTTAAGCGAGGAGAAGGAGTTACGGCGGAAGCGCCAACGGTAGTTAGGAAGAGTCGAGTTACTAGTCGAGGACGTACCTACTCTACTAGGAAGAACTAGAAGAATAGGAGCCGCAACACAC
Strand-3	ACATCCAACACTCTACGCCCAACAACAACAACAACGCCGCCAACGGCGGCAAGTCGACGAGTACGAAGTAAGACGCTCAAGACCTCCTCCTCTCGACGAGCCTAAGAACGTAGAGAAGGAGAACCGCGTCGTCGTTCTACGCTACTAGCCTAACTCTCAACTCGGAACTCTAGTTCGGCAAGTAGACTCCTAGCTCGTCGTACGGACGCTAGTAAGACGAACTACGAAGAGAATAGGAGCCGCAACACAC
Strand-4	ACATCCAACACTCTACGCCCAACAACAACAACAACGAAGAAGACAAGTTAACTAAGACTAGAGACGGAGAAGCCTAGACCTACTACGTCGGACGCAAGTACGGCTACGTCGCCGGAACTAGGACCGTTACGAAGGAGTAGAGCAACGAAGCGAGAAGTAGAACGCGCGGAGACGGACTCGGCAACGGACAAGGCCGGTAGACGTAAGAAGCGACGAGACAAGAGTAGGAAGAATAGGAGCCGCAACACAC
Strand-5	ACATCCAACACTCTACGCCCAACAACAACAACAAGACCGCTAACTACTACGAACTCGAACAAGTCTACGCGACCGGCAAGAGTTAACTCTAAGACAACTAGAACAACTAGAGCGCTAGACCTCTCTCGACTAGACGCAAGACCTCGGAAGACTAGTTCAACGAAGCGAGGACCGTAACTAGAGACCTCGCTACTAGTTAACCTAGTCGGAGGTACAAGACCAAGAACTCGGAATAGGAGCCGCAACACAC
Strand-6	ACATCCAACACTCTACGCCCAACAACAACAACGTCGAAGGTAACTAGTACGCCAAGGAACCTCCTAGCGAAGGCCTACTCGAACGCGGCGGTAAGACTCGGTCGAACGCTACCGCCAAGAAGTACGGTAGTAACTCGAACGAACGCGGAGAAGAACAAGTCAAGTAAGGAACCGCTCTCTACGTCGCCTAACCTCCTACTCGCTCGAGGTTAACTCTCGGTTCGAGCAACGAATAGGAGCCGCAACACAC
Strand-7	ACATCCAACACTCTACGCCCAACAACAACAACGAAGAAGACAACTAAGCGAGCGCTCGCGTCTAACGACAACCTCCTACCGGAAGAGGACAAGCGACGAGCAAGAGCGCTCCTCCTAGTAGACCTACGGAAGTCTCGTCGAGTAGGTCGTTAGAAGACCTCAACTAAGGATCGTAAGCCAACCTAACGAGCGGCCTCAACTAGAGAACGTCGGAACAACGAGAAGGAAGCGAATAGGAGCCGCAACACAC
Strand-8	ACATCCAACACTCTACGCCCAACAACAACAAGACCGCTAACAACCTCTACGTCGCGACCGCGTAAGTCTAACGCTACGTCGTCGCCGCTCTCGCGAGGTTAAGACTAAGCTCGAAGACGTTAAGGAGAGACTACCTACTCCTCAAGAGTACCGTACGACAAGACTAACTCTACGAAGTCGCTCGCCTCCTCTAAGCGAGGAGCGGTAACGCCTAGTTACAACCTACCGCGGAATAGGAGCCGCAACACAC
Strand-9	ACATCCAACACTCTACGCCCAACAACAACGTCGAAGGTAACAACGGTAAGAGGTAGTAAGCCAAGTCGTTCGCCGAACCTAAGAGAAGTAAGTCGTAGACTCGGAGTTCGAGAAGGACGAACAACGCTCAAGAGAGACTACGAACGAAGAAGTTACGCGCCTCGACTCGCCTCGCTCGAAGTAGTAGAACTAGAACGTAGACCTAGAGTCGGTAAGCCTAACAAGTCCTAGAATAGGAGCCGCAACACAC
Strand-10	ACATCCAACACTCTACGCCCAACAACAACGAAGAAGACAACAACTAACAACGACGCCTCCTCGTCAAGAAGAGCTAGTTAACGAAGGAGACTAGCTAAGGACCTCGACTCAAGACTCTCAACGGCGCGACCGTTAGTCTACGCGGCTACTACTCGAAGTACGCTAGAACTCCTCTCGTCCTCGAAGGACAACAAGTTCCTCTCAAGGAAGCCGTTACCGCTACCGCTCGGGAATAGGAGCCGCAACACAC
Strand-11	ACATCCAACACTCTACGCCCAACAACAAGACCGCTAACAACAACTAGTAAGGTTACTAGAGTCTACAAGGAAGGTTAACTCGCGGAAGTAGGAACTACGGAAGCTAGAAGAGAAGTTACGAAGAGGAAGCTAACGAAGGAAGGAGAGACGCTAGTACCGTTAGTACTAGCTCGAGCAACGCTCGAGTCAAGACTAACTCGACGTTAAGCCTAGACGTCGCGTCGAGCGGAGAATAGGAGCCGCAACACAC
Strand-12	ACATCCAACACTCTACGCCCAACAACGTCGAAGGTAACAACAACGGTACTCGGCGGCGGTACGGACAACTCGGACAAGGCTAGTTCGAAGCCTAGACGTTCTCGACTACGAGTAACAAGAAGAGGTAACGAAGACTCGCCGAAGAGACGAGGTCGAACGACGGTTAAGCTACGACCGTACGCGCGTTCGGAACTAGTAGGCGGAGCGGCTCTAGAGACGCTCTACGAAGAGAATAGGAGCCGCAACACAC
Strand-13	ACATCCAACACTCTACGCCCAACAACGCCGCCAACAACAACAACGCTAGTACTACGAACGGCGAACTCAAGAGTCTCTAGACTACCTACAACAACTAGAACGTCGCCGCGGAACAAGCTCAACCTCGCGGAAGGTTCGTCCTAAGTAACTAACGAAGAAGACAACGCGAAGAACGCGCGAGTAGTTACTACGCCGGTTCGAACTAAGAAGTTAACTACGCGAACTAGGAAGAATAGGAGCCGCAACACAC
Strand-14	ACATCCAACACTCTACGCCCAACAACGAAGAAGACAACAACAACGGCGCTAGGTACTACGGAGAACTCGGCGGCGGCGCTCGAACTACCGTACCTAGAAGATCGACGAGAACTACTAAGAGGAAGTTAACTAGGACGACGACGGAAGGATCGTTACTACAAGCCAAGTACCTACGCGGTACGAGGTCGTTCTCGACGTCGAGTAGAACTCGCCTCGCTAAGTAAGACAACGAATAGGAGCCGCAACACAC
Strand-15	ACATCCAACACTCTACGCCCAACAAGACCGCTAACAACAACAACAAGAGTAGATCGTTAACCTCGACTCTACGACGCGGCGCCTAAGAAGGTTCGGAACAAGGCGGTAGACGCGCGTCGACGACCTAAGGCCTACGCCTAGAGTACTACGCCGGCTAAGTCGCTAGACTAGAGAACGGTAGGACGGAAGCGAAGTCGTTAAGAAGTCGGAGCTCGTTAACTAAGTACGGTGAATAGGAGCCGCAACACAC
Strand-16	ACATCCAACACTCTACGCCCAACGTCGAAGGTAACAACAACAACGGCCTAACGACTCGCCTAACTCAAGACGCCGTTAAGTACCTAAGACTAAGAAGAACGGAAGAGAGCGGTTAGAGTACTACGTTCGCCGGAGAGTACCTCTACGTCTACGGAGAAGCTCGGACCTCGTTCGGCGCTACCGAAGCGAGCCTCAAGAGACAACAACTCGGTCTCCTACCTCTCCTACAAGAATAGGAGCCGCAACACAC
Strand-17	ACATCCAACACTCTACGCCCAACGCCGCCAACAACAACAACAACGAAGCGAAGACCTCGTTCCTCCTCTCGTCGAGTAGGAAGACGTAAGACTAGAGGAGGAGAAGCTAAGCCGTCTACGCCGAAGAACGAAGAACGACCTAACTCTCGTTAAGAGAAGACGGACCTACCAACCTCGCCGTCGGTAGGTAACTCGGCGGTTACCTACTCGGCGTCGGTCTACGAGACTAGGAATAGGAGCCGCAACACAC
Strand-18	ACATCCAACACTCTACGCCCAACGAAGAAGACAACAACAACAACTAAGGTAGCGAACCTAGACAAGCCTACGCGAACGTCTACTCGGAAGGTCGGAGTCTCGCCGAAGCTCCTCAAGCTCAAGCCTAAGAACGCTAGAACTAGGAAGAGAGAAGCCTCCGTCGGTCGTTCTACTACTCGAGGTCGTACGGAGAAGTCTAACAAGGCCTAAGAACTCTAAGCTCGAGGTAGGAATAGGAGCCGCAACACAC
Strand-19	ACATCCAACACTCTACGCCCAAGACCGCTAACAACAACAACAACGCCTCGAGGACGAACTACAAGTTCGCGAGACCTACCGTAGAGGAACGAGAACGACGCGCTCTAACTACCTAACCTAGTCGGACTCGACGCAACTAGAGAAGAACGTTCGCCGCTAAGAACGCGACCAAGAGATCGTCGGAAGTCTACGCTACGACGTCGACTCGGACTCGGCGGTCGAACGCTAACGAATAGGAGCCGCAACACAC
Strand-20	ACATCCAACACTCTACGCCCAGGCGGAGTAACAACAACAACAACTAAGAGAGGACCTCGAGGTTCGCCTAAGGTAGTAGTCTACTCGCTCGGTCGGAAGAAGCCGTAACGGAACAAGCCGGCGAACGAAGTAGGTTCGGCGGTTAGACCGAAGACGAAGCTAGAAGGAAGAGCGGAGAAGCCGTTACTAGGAGTTACAACTCGTAAGCCTACTAAGTCGAAGCGTAGAGCGAATAGGAGCCGCAACACAC
Strand-21	ACATCCAACACTCTACGCCCACCGCCAACAACAACAACAACGACGTCGCGTTCGGTAAGGAAGGCGAAGACGTCAAGACTACCTACAACCTAAGAAGGTCGTCGACGTTAGAAGGAAGCTCGAGAAGGTAGAGGTAAGAGAGCGGAACCAAGTCGTAGTACGAAGCGTAGAGTAGGAGCTACTCGTAACTAACTCGGACTAGTAGTAAGAGGAGTCGGTAGAGCTAAGCCGAATAGGAGCCGCAACACAC
Strand-22	ACATCCAACACTCTACGCCCGAAGAAGACAACAACAACAACAACGCGTACCTCGCCGTCCTAAGCGAAGGTTAAGTCGTCGCGAAGACCGCCGTCGTCTAAGAAGCGACTAGGACCGTACCTCCTCTACTCAAGAGCGCTAAGAAGGCCGCCGTCGCCGCGAAGAGAGAGTTACGCGCCTACTCGTTACCTCCTAGAGAACAACCTAGCGTAGAAGTCCTCTAGGAAGACGAATAGGAGCCGCAACACAC
Strand-23	ACATCCAACACTCTACGCCCACCGCTAACAACAACAACTACGCCGAAGGAACCGGAAGACCTAGTCTAGAAGCGACGTTCCTCGCGACTCGGTAACGAGAAGAGTCGACCGCGACTACTCAAGAAGCCTCGTTCGCGTTAACGTAAGGCGTCGGAAGCGCGAAGTTCTACTACTCGTCGCGGACGAAGAAGTAAGGTAACGGTACCGGCGAAGGTAGCTAGGAAGCTAGTGAATAGGAGCCGCAACACAC
Strand-24	ACATCCAACACTCTACGCCCGAAGGTAACAACAACAAGAGTCGGACCTAACTACAACGAAGTAGCCTCCTCGTCGCTCGACTCCTCTCTAGCTACGTCTAAGGTAGGACGTTCGGAGACGGTAAGTTCGTCAACGGACAAGAAGTCGGTCTAAGTAGTAGAACCGTTAGATCGAAGAGAAGGAGTTAGAACGGACGCCTCAACTACTACTAGACGTTCAACGCTCGACTAGAATAGGAGCCGCAACACAC
Strand-25	ACATCCAACACTCTACGCCCACCAACAACAACAACTCGTAGAAGTAAGCCGGAGACGGTTCGAGCGTCTACTACTACGCTCGCGAAGAGACCGAAGGTCTAACGAGAAGAAGCGAAGAAGTCGCCTACGGAAGGTTAAGAACTACCGTACGAACGTCGACTACGAACTAGTCGAAGTAAGCTACCTCGAGAACCGGTACGACCGTAAGAGACTCGTTAGACTAGTTCCTAGAATAGGAGCCGCAACACAC
Strand-26	ACATCCAACACTCTACGCCCGAAGACAACAACAACGGAGAAGTCGTCGAAGTCTAACGCGCCGCCGCTACCGGAACGACTAGTCTCGGCTCGTTCGGCGAACTCAACAAGACTCGACTAAGTACGTCGAAGAACGCTCCTCAAGGCGTCCTCGCGTTCGAACGCAAGAGGTCGTACCTAGAACGCCTCTAGTTACTAGAGACTAACGCGAACTAGGAAGGAAGGAGCAAGGAATAGGAGCCGCAACACAC
Strand-27	ACATCCAACACTCTACGCCCACTAACAACAACAACCTCGGTAAGTTACGCGGTTCGAACAAGTAACTAAGTAGGAACGAAGCTAGTAGACTCGGAGACTAACCTCTCGCTAGAAGTCTAACCAACGCCTACTCGTCGAGTACTCTAAGCGGTCGGCGGAGTCGGAACGCCGCGAGGAGTAGAAGAACTAGCTACCTAGACTAGACTAGAACCGTCGGACCTCAAGAAGGTGAATAGGAGCCGCAACACAC
Strand-28	ACATCCAACACTCTACGCCCAGTAACAACAACAAGTTCAACGTCGCTACGACCGCTCCTCTCGTCGTCGCCTAAGACAAGACCGAAGAGGAAGAAGCTCGCTACCTCGGACAACTAGAGAGTTCGAGCTAGACGAGCCTCTAAGCTCCTAGATCGAAGTCGACTAGCGGCTCGACTCGAGAACAAGACCTAAGGACGACGGAAGAGACCGTTCGAAGTTCGTTAGACTAGGAATAGGAGCCGCAACACAC
Strand-29	ACATCCAACACTCTACGCCCAACAACAACAACTCGTTACCTAAGTAAGCCTAGTAGACCGCTAGAAGAACGACCTCGAGGTAGACTAGCAAGAACGTCGGTCTCGCTCTCGTCTCGTTAAGTCGGTACTACGTCGCGTTACCTCAACAAGGTTCGAAGACGTACTAGTACGGTCTAAGTCTAACCGTTCGACTCTAACCTACGAGTAGCAAGTTCGGCCTCGGAAGAAGAGAATAGGAGCCGCAACACAC
Strand-30	ACATCCAACACTCTACGCCCAACAACAACAACGGACGCGGTAGGACTACGTACTAGAAGTTCCTCGAAGAACGCGGCGAACTCGTCCTAAGGTCGTAACTACTACAAGCTAACTCGAGAGAAGAAGGTACGAGGTTACTCTAACCTAGGACTCGACGCGGCGGCTAAGGCCTCGGAACGTTACTACGAAGACTAAGCAACGCTAGGTAGAACCTAAGCTAAGCGACCGGAGAATAGGAGCCGCAACACAC
Strand-31	ACATCCAACACTCTACGCCCAACAACAACAACCTCTAAGACGCTCTCTCGTCGAACGGAGAACCTACGAACGTCAAGAGACTCGCTCGACAAGCGAGTCTACGAAGCGGTAGGACTAGAAGTCGGTCGTTCCTACTAAGGTTCTAGAGCGGTCTCCTACTACGAACTAGCGGTTCTCTCTAGAGCCTACTCTAGTAAGAGAACTCGAGCGGTACTAGCAACGAACTACTAGAATAGGAGCCGCAACACAC
Strand-32	ACATCCAACACTCTACGCCCAACAACAACTCGTTACCTAAGAACGCGACCTCGAGTAGCTAGAGAAGTTCGTAGAGATCGTAGTACGTCGGCGCCTCGTACTAGACCGTTCCTAACCTCGTCGGCGAACTCGTCGCCGCTACCGTAGAAGCTCTACGCGTCCTCCTAGAAGCGACTCTCCTCGGAAGTTAGAGCGCTACCTACGAAGCCTAACGACTACCTAAGTTCAACGAATAGGAGCCGCAACACAC
Strand-33	ACATCCAACACTCTACGCCCAACAACAACGGACGCGGTAGGAACCTCGGAAGGAGTAGCCTAAGGTAGGAAGGCGAACCTCGCGCCGGTCGGAGTAGCAACAAGTCGAGCGCTAGACTCGTCAAGAGACTAAGCTAGACCGTCTAGTAGTTCGTCTAGAACTAGAACGAACGCGAAGTCTAGGAAGCGACGTCGTCGAGATCGAGGTAGAGTAGGAGACAACTAACTAGTGAATAGGAGCCGCAACACAC
Strand-34	ACATCCAACACTCTACGCCCAACAACAACCTCTAAGACGCTAACGCCGTAAGTAGTAAGTTCAACGAACAACCTACGTAACAACGCAACGGACAAGGCGCCAAGTAACTCTAGACTACGTACGGCGTCAAGTAGTCGTCGAGTTAAGAAGAGAGTTAACGGTTCGAAGCCGTTCGAAGACTAAGTTACCTCTAAGGCGGTAGTACCTCGAGGTACTAAGGTAGGAGGACTGAATAGGAGCCGCAACACAC
Strand-35	ACATCCAACACTCTACGCCCAACAACAAGTTCGCGAACGGTAACGCGAAGAGAAGTACGTTAAGAGAAGAACGATCGTAACAAGCGTTCAAGTAAGCGACTAGGTCGACCGTTAGCCTAACCGTCTAAGCGTCGTAAGACTAACTCCTAAGGACTCGGAGACTAACGACTAGCGCGAAGACTCTAAGCGGTCTCAAGTAAGGTTACGGCAACGCGTAAGTCTAGTAAGACGAATAGGAGCCGCAACACAC
Strand-36	ACATCCAACACTCTACGCCCAACAACTCGTTACCTAAGAACAACGGAAGCGGTAACGGCGGCTCGTAGAGGTAAGGACAAGTCGCTACTCTCTAAGTCTAACCTCCTAACGAAGACGGTAAGAAGAAGAGCGTCGCCGCTACGTACTAGAAGAGAGAGAGACCTAACTAAGGAGAAGCGACCGGAGACGTCGGACGCGTCTAACGCGCGGAAGGCCTCGGTTAGACTACCGAATAGGAGCCGCAACACAC
Strand-37	ACATCCAACACTCTACGCCCAACAACGGACGCGGTAGGAACAACGCCGTTCTAAGTAGACTCGAAGGCCTAACGTCGTCGACTAGTACTCGCCTCCTCTACCTCTCGAAGAAGAACCTCTAGAGGTAGACGAACAACTACTAGAAGAGCTAAGACGGTCGGACTCTCGTCTAAGCGAAGAGCGTCCTAACGAACTCGTTACCTACTCAAGCGACTAAGACGAACGGAGAAGAATAGGAGCCGCAACACAC
Strand-38	ACATCCAACACTCTACGCCCAACAACCTCTAAGACGCTAACAACAACCTAAGTACCGGAAGAGACGCGACGTTAACTCCTCGCCTCGGTTAGAGGTTAAGGAAGACCGCGAACGAAGCGAACCGGACCTACAAGTAACGAACTCCTAGTCGGAGGTCGGAACGAGACGGTAGAAGCTCGTCGACTCTAAGGTTACGCGCTACGAGCGGACGCTCGAAGAGGTTAGTCGAAGAATAGGAGCCGCAACACAC
Strand-39	ACATCCAACACTCTACGCCCAACAAGTTCGCGAACGGTAACAACGAAGTCGGCGAAGAAGCTAGACTAGAACTCTAGAGTACCGAACGAAGTAGCGGCGGCAAGTAAGAGTACGGACAAGCGAGCTACTACGCTCTACGACCTCTCTACGCGAGTCGGAGAGAAGCCGTTCTAGACCTCGTCAACTAGAGCGCTACGAGTTACTAGTAAGCTCGCTACGCTCGGTAGAACGAATAGGAGCCGCAACACAC
Strand-40	ACATCCAACACTCTACGCCCAACTCGTTACCTAAGAACAACAACTAACAACGCGGTAGACCTCCTACGAGCGGAAGGTTCTCGACCAAGACGAGTAAGAAGTTAACCGTTCGAGACGGACTAACCGAAGGACGCGCGAGTCGGAAGACCTAACGGTTCTCGTAAGAACTCGCGTAGACCGGCGTCGGTCTCGCCGTTAAGTAACTCGTCAACGGCGGTAGCAACGTCTCGGAATAGGAGCCGCAACACAC
Strand-41	ACATCCAACACTCTACGCCCAACGGACGCGGTAGGAACAACAACGGTTACGGACCTACGTTAAGTACTAGCTAGAGGACTAGTAGGTCGAGCTAGTACAAGACCTACGGCCTAGAACAACCTCGACTCGCGTAGAAGACCGCGACCGCCTACGCTCTAACCGCCGTACGACTAGACGGCTCGTTCGTCAACGCTACCAACGTCGCTCTAAGACGTCTCTAGAGCTAAGGAGAATAGGAGCCGCAACACAC
Strand-42	ACATCCAACACTCTACGCCCAACCTCTAAGACGCTAACAACAACGCGTTAGAACTAGAAGACAACGGACAACGACCTCTCGCTAACGCCAACGGATCGAAGGAACGAACTAGCCTCGGTTACTAGACCGTCAACGGCGGAGAGACGACCGAAGGCTAACCTCGGAGCGGACTACTACGCCTAAGCGCGAACGTTAACGGACGTAGCCTAACGGAAGCGAGCGCTAGAGACGAATAGGAGCCGCAACACAC
Strand-43	ACATCCAACACTCTACGCCCAAGTTCGCGAACGGTAACAACAACTAACTCTAGAGTTAGACGAGGACGTTAACTAGGAGGACCTACCTACTCGCTACCGCTCGGTCGTTACTCGCCGGCGTCGCGAGTAGCAACCTCTACAAGAGGTTCAACTAGGAAGCTCGCGAACAACCTAGGACTAAGTCGTAGTCGTACGGACCTCGGAGGAGTTCGTAGTAACGCGGAACTAGGGAATAGGAGCCGCAACACAC
Strand-44	ACATCCAACACTCTACGCCCTCGTTACCTAAGAACAACAACAACGAAGGCGGCCTCCTAACTAGCGGCGGCGGTTCGAACGGTTCGACGAAGAACGTCGGCAACGGCGTCGAAGTCCTCGGAAGTAACAACCTACTCCTAAGAGAAGAAGGCGCGTTCGGCGCTACTACGAGAGAGTCGAGCGGTTACGAACAAGCGACTACGAAGTAGGAAGGAAGATCGTACGCTCTAGAATAGGAGCCGCAACACAC
Strand-45	ACATCCAACACTCTACGCCCAGACGCGGTAGGAACAACAACAACAACTACTCGAGACGCCTCTCGTACTAAGGAACGTTCGCCGAAGCCAACTACGGACGCGGCCTCGGAGAGAGCTCGAGTAGACAAGCGTAGTTCGCCGCGAACCTCGGAAGCTAGAGAGAAGAGACGGAAGCTCCTAGCAAGAGACTAAGGAGTCTCTAAGGCGTCAAGTCTAGCTAAGGCGAAGGAGAATAGGAGCCGCAACACAC
Strand-46	ACATCCAACACTCTACGCCCTTCTAAGACGCTAACAACAACAACGGTTAGAGACGCTCGACCGGAACCTCGTCGAGAACTCGCGCGACCGCTACCGTTACGAGGAGGAACAAGACGAACGCGTAAGACTCGAGCTCGTAGACGAGATCGAACGAAGGTAGTTAGAGTCTACGCTCGAGAACGACGTAAGTCCTAACTAAGTTACTAAGGAGTAGCAACGGCGCCGAACCTGAATAGGAGCCGCAACACAC
Strand-47	ACATCCAACACTCTACGCCCTTCGCGAACGGTAACAACTACGCCAAGTCGTACTACAACGCGACGACTACTAAGTCGTCGTAGACCAACGGTAGCCTCGGCAAGAGAACGACGTCGAACTACGTCGCTAAGACTCGCGAAGCTCCTCGAACGTTCGGAACTAGCGAAGGAACGAACGGTAGAAGAAGCAAGTAAGGTAAGAAGTCGACTCGCGCGTTCGAACAAGTCGGCGAATAGGAGCCGCAACACAC
Strand-48	ACATCCAACACTCTACGCCCTTACCTAAGAACAACAAGACTCTCTAGACGACGTAGTTCAAGAAGTAGGAACCTACCGTAAGATCGTTAAGCTACAAGTTACGCTAAGACTAAGCCTAACTAAGGTAAGCCAAGAGTAGACCTAGAAGTCTCTACAAGGAACCTCGCGAAGGCTAAGCCGGTCGGAACAAGAGCGCGAACGGCAAGAGAGAAGCGACTCGCAACGCCTACGAATAGGAGCCGCAACACAC
Strand-49	ACATCCAACACTCTACGCCCTAGAGTAGGAACAACGTCGCCTAAGTCGCTCTCGGATCGTACAAGAGTTAAGGTTAACGCCTCCTAACCGTTAACGCGTTCGGAAGTACTCGGTAGAGTCTCTAGTCGACTACGACCGCTCCTACGGAAGGCCTAAGCTAAGCTAGCGCGACGACGAGTAGGAGTAGCGGTAGACCTCGCTCGAACAAGGAAGAAGTCGAACTACCTAACGAATAGGAGCCGCAACACAC
Strand-50	ACATCCAACACTCTACGCCCTAAGACGCTAACAACGCTAGATCGAGTCTCAAGTAGTACCTCGTCGCTAGAAGTACTACCGTCGCTCTCGCGTAGTAAGACTAAGGAGAGTCGTCGAACTACGCGTCGTAGTAAGGCGTCTCGTTACTCGGAGACTCGAAGTTCGCTACCGGACCTAAGACTCTCTCGTACGAAGGTTAAGCGACCGCCGAACGCTAGACCTAGACCAACGAATAGGAGCCGCAACACAC
Strand-51	ACATCCAACACTCTACGCCCACGAACGGTAACAACGGTAGGTCGACTACGACGTTAAGACAAGACGTCTAGTCGAGAGAAGACGGACGCAACGGTACCTCGTCGTAAGTCTACTCGTTCTACAAGAAGACTCGCCTAAGATCGAGCGCTAGCGCGTCGAACTAAGGAGAAGCTACTACCTAACTCTACTCGACTCTAAGGAACGCTCAAGAAGAGACCGGCGCGAACCTAGAATAGGAGCCGCAACACAC
Strand-52	ACATCCAACACTCTACGCCCTACAAGAACAACAAGAACGCTACGAAGAGTAACGGAGAAGGATCGTAAGCCAAGAGCCTCTAAGGTAGACAAGGAACCGGCCTCGAACGCTCGAGTAGGTTAAGTAGAGACGCGTACAACAAGAGGACCAAGACGTCGGAACGACTCGCGTAACGAACGAGTTACTAGGAAGTCGGTCTAGACGTCTAAGCTCGAGAGACTACGAGTAGAGAATAGGAGCCGCAACACAC
Strand-53	ACATCCAACACTCTACGCCCAGTAGGAACAACGTCAACGCTAGCTACGGTTAGTTCGAAGGCGCTCTAGAGAAGAGAGAGAGCGTCGGACTCGGACAACAACGCGCTACGAACTACGGCGCCGTAGAAGCGACCGTCGCGAACAACGGTCTAGAGAACGCTAGTAACTAAGACGGTACCGCCGTCGAACTAACTAACCTACAAGCTCCTCAACGAGACAAGTTCGTCGCGGAATAGGAGCCGCAACACAC
Strand-54	ACATCCAACACTCTACGCCCAACGCTAACAACTCCAACGCCGGAAGAACGACTAGGCGGACTCAAGGAAGACTACTCGCCTAGTTCGCTAACTAGAACGAAGCTAGCGTCTAGAGCAAGAGAAGATCGTTCGCCGGCTCGTAAGCCGGCGCTACGAAGTACGAAGGTAAGAACGGAGAGTAACAAGCCAAGGCTACTACCGGTACGAACAACGCCGTTAAGAGTAGGTTAGAATAGGAGCCGCAACACAC
Strand-55	ACATCCAACACTCTACGCCCAACGGTAACGACGGTAACGAACTACCTAGTAGAGACTAGACGAACGCTAGGAGGTAGTACAAGAGTCGGTACTAGAGTACGTCGTAGACTAGAAGCGCGTTCTAGACGTCGTTAGAGTCGTACGGCGCCGTCAAGACTAGGCGGTCGTCGAGCGCGACCGTTACTCTCGGTAGACAAGCTCCTAGCGTCCTCGGACGCGGAACTACTAGCGAATAGGAGCCGCAACACAC
Strand-56	ACATCCAACACTCTACGCCCAAGAACAACAAGAACAAGACCTACGCTAGAGAAGACGGACTCGCTAGAGACGCGTTAACGACCTACAACGCGTAGAGCTACTCGAGAGAAGCCGCCGGTTAGAGGTCGAGGTCGAGGTCGAACTAAGGAGACCTCTCGACTCGCAAGTACTAGAAGGAAGTCGCGACTACGAAGACTCGACAAGGTCTAAGACCTACCGTAAGATCGTCGGAATAGGAGCCGCAACACAC
Strand-57	ACATCCAACACTCTACGCCCAGGAACAACGTCAACGTCTAAGGTAGTTAAGGAACCTAGACCGTTCGCTACGCTCAACGCGTCGCTCGAGAAGAGAGCTAAGAAGCCTCGAGAACGGAACGCTAAGCCGGTACCGTAGAAGCGAGACTACTAACCGTCTACCTAAGTCTCAAGTAGAAGAGTAGGAGGTCGAGAAGGAGGACTCTCAACCTAAGGAACGCGAGTAGAAGCGAATAGGAGCCGCAACACAC
Strand-58	ACATCCAACACTCTACGCCCAGTAACAACGGTAACGAACTAGACGGTACCTCGTACGGACCTCTAACTAGAGACGGAGAGAGCTCGTCGTTACCTCGCTAACTCGCTAGAAGAAGAGACGTCGCTAACTAACAAGCTCGCGGCGTCGGTCGGACCAAGACTACTAGGTACGCTAGACAAGCCGCGAAGTTAGAACGAAGAAGTCTAAGGTAGAAGACCGTAAGCTCGAGCGAATAGGAGCCGCAACACAC
Strand-59	ACATCCAACACTCTACGCCCAACAACAAGAACAAGACCAACGCCGTCGGTTAAGCTCGCAACTACGTCGAACAACCTAGGAACGCTCAACGCGGTACGTAGACTCTAAGCGGTTAGAGGACCTAGAGGTACCTACGCGTCGTCTACGGAAGCGCCGTCGCGAGTAGACTAACGAACGGCTACAAGTTACGACGCAACAAGTAACTAACCGTTCAACGAGACAACAAGTTCGAATAGGAGCCGCAACACAC
Strand-60	ACATCCAACACTCTACGCCCAACAACGTCAACGTCGAAGACGAACTAAGCCTCTACGGACCTCGGCGGAGCTAAGGCTAACGCCTCGCGACTAACTAACGTTCGAGCGCCGGCGAACGCGGCAAGTTAAGCGCGTTCGAAGGAACTAGAAGTAGAAGAGAACTAGAGAGATCGTTCAAGAGGTTAACCGCGAGTAACGTCGGACAAGGACTACTAACGACTACGACTAAGGAATAGGAGCCGCAACACAC
Strand-61	ACATCCAACACTCTACGCCCAACAACGGTAACGAAGGTAGGAGTAGTCTCGGAAGCGCCGGACCTCTACGAAGAAGCGGCGAACCTCTACTCTAACGACGCTCGAAGGAAGCTACGTAGTAGAACCTCTAGTAGTTACTAACGTTCGAACGAAGCTAGTCGTACCTACAAGAGACTAGCCTAACTAACGGACCTCGCTAAGGCGCCGCGGAAGCCAAGACGTTCGGAACCGAATAGGAGCCGCAACACAC
Strand-62	ACATCCAACACTCTACGCCCAACAAGAACAAGACCAACGCCAACAACGGCTACGGAACGACGAGGTCGTCGACGCGGTCGTCGTAAGGCGCTAGACTAAGCTAAGGTAAGTACTAGAGAGAACTCGCGTACGCTAGGTCGAGTTACTCGACGAAGTAGTACTAGACCAAGAACTAGTAACGAACCTAACTCGCGACTAAGAGGTAACTCGAAGCCTACTACGCGACCAAGGAATAGGAGCCGCAACACAC
Strand-63	ACATCCAACACTCTACGCCCAACGTCAACGTCGAAGACGAAGACGGCCTAACTAGTACTCTAGAGGAACAACTACGAAGCGAAGTCCTCTACGCGACTCGACGCGTCTACTAGAAGAGTAGTTACGAAGCCGTTCGGAAGACTAGTTCCGAACAACTCGAAGTCTAGACCGTAAGAACTCAAGAACGCCTACCTACCGGTCTAACTAAGTAAGGTTCGACGAGATCGACGGAATAGGAGCCGCAACACAC
Strand-64	ACATCCAACACTCTACGCCCAACGCTAACGCCGCTAAGACTAACAAGTAACGCGAACAAGCGTTAAGGAGGAACTAAGCTCTCCTCCTCGGCTAGTCGACCGCCTAAGGTACCGGTAGCGCGTAAGAAGGCTCGAGCAACGCTAAGTAGAGTAACTCGAGCGACGCGTCGAGGTACGGCCTACTCTACGGACAAGTCTAGTACCTCAACAAGAGGACTCAAGGAACGAGGGAATAGGAGCCGCAACACAC
Strand-65	ACATCCAACACTCTACGCCCAACGGTAACGAAGGTAGGAGTAACGGTCTACTACTCAAGTCGACCGGTCGGTTAACGTAGTAAGTCGCCTAGTCGAACTACTAGAGAACTCGATCGAGGTACAACGCTCAAGCTAGCTACTACAACCTAGAGTCGACTAGAAGCGGTACCGGCCTAAGCGAAGGTAGTAGGCGGAGGAGTAAGTTCAACAACGTCGCTACGACCGGTACCGAATAGGAGCCGCAACACAC
Strand-66	ACATCCAACACTCTACGCCCAAGAACAAGACCAACGCCAACAACGCGAAGACTAAGTACGTCGCGACTCCTCGCAACTAGAAGTTCGAACGACGCAACTCGAGGAGGAGGACGTAGTTAACTCCTACTCTAACTCTAGAAGACGGTAGGAAGTACTAGACGAGCTCGACCTACAAGTACGCCAACGGCGTCGAACGCGGTACCGTTCTCGCCGAAGAAGCTAAGAGACTAGAATAGGAGCCGCAACACAC
Strand-67	ACATCCAACACTCTACGCCCAGGAACGTCGAAGACGAAGACAACGGAGACGGAACTCGCTAACTACGAACCGGTTAACTAACTCTACTCCTCGAACGCAAGAGAAGTAGGTTAAGGCGGAGGACGGAAGCGACTCGGACTCGAACGAACGCTCTACGCGAACCTCGAGACGGTTAGAGGCGGCGGAGCGCCGGTTAAGCGGTAAGAGAGTAAGACGGTTCGAAGTACGTAGAATAGGAGCCGCAACACAC
Strand-68	ACATCCAACACTCTACGCCCACTAACGCCGCTAAGACTAACAACGGTACTCGAACCGGTAACAAGAGGTACTAACGCCTAACTCCTACTAGTAGAACCGTTCCTCGGTTAGAAGGCCTAAGAACTAACGCGTAACGAACGGAAGACAAGACCAACAACCTCGTCGAAGAACTAGAGTTACGAAGCAACGGCGGCGGTCGGAGCGGACTCGCTAGGAGTCTACGCGGCTACGAATAGGAGCCGCAACACAC
Strand-69	ACATCCAACACTCTACGCCCAGTAACGAAGGTAGGAGTAACAACTACGGAACCGGAGAGTACGAAGCCGAAGCCGTCTCGAAGAGTAACGGCGCTCGGAGAAGTAGGAGAAGTTAACCTCCTCTCAAGAGCTAGAGGAAGACCAACTAGAGCTACGAAGCGTAGGAACGCGGAAGAAGAAGGAGGTAAGCTCTCGCGAGTACCAAGTCGTACTAAGCTAAGTAACTAAGCGAATAGGAGCCGCAACACAC
Strand-70	ACATCCAACACTCTACGCCCAACAAGACCAACGCCAACTACGCCGCTACTACGAACCTCTACCTACGAACGGAAGAGACTCGAACTAGTCTCCTAGACGAAGCTCCTCGGACTCGACGCTAGAGCGCCGGAAGGTTCGGAAGCGTCCTACTCTAGTAACCTAACAACCTCCTAACTAAGTTCGCGACTACGAGGTTACAAGAAGTCAAGTACGCGACGACCGTTCCTCGAGAATAGGAGCCGCAACACAC
Strand-71	ACATCCAACACTCTACGCCCAACGTCGAAGACGAAGAGAGTCGGAGACCTAGAAGTTAGACCGCTACTCTAGAGAGGTCGACTAGGAGAGACCTCTACCTAGAGTAGAGCCTAAGCGCTCTCCTAAGAAGCTACGGAGAGAGGACTACTCGCGGATCGAGATCGTCGACCTACGCGAGTAGTAGGAACAAGTTCCTCTAACCTCGGAGTTAGTTACCTAAGTAACTAAGGGAATAGGAGCCGCAACACAC
Strand-72	ACATCCAACACTCTACGCCCAACGCCGCTAAGACTCGAGAGACTAAGAGTAAGTAAGTCGCCGCTCGACCTCGACAAGTCAACAAGTACTAGAACTAACCTACGAGTAACGAAGGTAAGAAGTACGGAAGCCTAGACGGTAACAAGTAAGCCGGACGCGCCTAGAACGGACGGAGTAAGTTAAGGAGCCTACCTACCGGAAGTCTCGCTCTCGCGTAGTTCGAAGGTCTAGAATAGGAGCCGCAACACAC
Strand-73	ACATCCAACACTCTACGCCCAACGAAGGTAGGAGTACGAGGAGTCTAGAAGCTAGCAACTAACGCAACAACGAACAAGCGAACGGACTAAGAACCAACTAGACCGGCTCGAACGCGGAAGCGGAACGATCGAACTAGAGAAGCCGCGGCGTCGCGAAGGAACGACGACCTCGCTAAGGACTCTAACTCGCCTACTCGTCGAGGACTAGGTAGTAGAACAACTAGGAAGAGGAATAGGAGCCGCAACACAC
Strand-74	ACATCCAACACTCTACGCCCAAGACCAACGCCAACTACGCCAACCTACGCCTCGCTAGCGCTAAGTAAGGCGCGTTCGCCGTTACCGTCGCGTTCGGTTCGTTAAGACTCGGCCTAAGAAGAAGCGGTTAGAGAGACGAAGCTAGACTACGCCTACTCGTCTAGTAGTAGACCGCCAAGTAGTTAGAAGGCTACTAACCTAACAACGGCGCCGCTCTACGAACCTAAGCGGAATAGGAGCCGCAACACAC
Strand-75	ACATCCAACACTCTACGCCCAGGCGGAACGAAGAGAGTCGGAACGCTAACGAACAACGAACCGGACTAAGAACGAGCAAGAGCGGCGGTAAGTCGTAAGAACTACTAACCTAACAACCTAGGCGGTAGGAACGCCTACTAACGTCGTTACGAAGGACCGGAGAACAAGAAGGCTCGTACTCGTCGACCAAGTTCGGTTAACTCTACTAGAGTAGGACGTACTACGGAGAAGAATAGGAGCCGCAACACAC
Strand-76	ACATCCAACACTCTACGCCCACCGCTAAGACTCGAGAGACTAACGAAGGAGAAGCCGTCGGCTACGGCTAGACTAAGTAACCTCGAGAGAGTAACTCGAGTCGGAGAAGGAGGTAAGCTCTCGCCTACGGTTCGTCGGAACGCAACTCGACTACGTTCGGCTCGTACTCGAACCTACTCTAGACTAGCGGACCTAACGGTTACAAGAGCTCGAAGTAGACGTTAAGTAGCGAATAGGAGCCGCAACACAC
Strand-77	ACATCCAACACTCTACGCCCGAAGGTAGGAGTACGAGGAGTAACAACGGTAGTTAAGACAACGCCGAAGAACAAGCTACGAAGAAGGAAGCGAGTCTAGACTAGACCTAGACCGTAACCAAGACGACTACTAGCGCTAGACAAGAGGAACGAAGACCTCAAGAGAGTCTAGAACTCTAGGAAGGAACCGGTAGAACGACCGTAACGTAGTCGACTAGACGAGGACAACGCGAATAGGAGCCGCAACACAC
Strand-78	ACATCCAACACTCTACGCCCACCAACGCCAACTACGCCTACGCCGCGACTAACGGAAGCGGACTCTCGAGCTACGTCCTACTACTCGCTACCAACTAAGGCTAAGGACCTAGCGGCGCTAGGAGGTAGTAGTAGTTACGCGGTTAGTACGGTAAGAAGAACTAACCTAACCAACCTAGTTCGAACTAGTAGTAAGACTAGTAGAGTAGCTACGCTAGGAGCGGCTAGAAGGAATAGGAGCCGCAACACAC
Strand-79	ACATCCAACACTCTACGCCCGAAGACGAAGAGAGTTAAGGTCGGACTAAGGAACGCAAGTAGTAACGCGGTTACTCGAGCAAGACTACGTCGAGTAAGTAGGAACGTCAACGCGGTAAGTTCCTCTACGCCAAGTAAGCTCGAGACCTCTACGGAAGGTAAGAAGGTAGCGAACAAGCCTAAGCGAGCTACGGCGAAGACTACTCGTACTAGGAACGAGACTAGAGTTAGGAATAGGAGCCGCAACACAC
Strand-80	ACATCCAACACTCTACGCCCACTAAGACTCGAGAGAGACGCAAGAAGGAAGAACAAGAAGAACTAACCGAAGGAAGGAGCCTCGGAAGCGGTAGTAGAGAGAACCTCGGACAAGAGACGTTCTACAAGAGCTACTACTAGAGGTTCGCGTAACAAGCCGTACTCAACGCGTTAAGTCGGACTCTAGAAGCCGAACGCGTCGGAACCGGACGCGGATCGACCGTCCTCGAAGAATAGGAGCCGCAACACAC
Strand-81	ACATCCAACACTCTACGCCCAGTAGGAGTACGAGGTTCGAAGTCCTAAGCGTCAAGACTACCTACGGACTCGCCAAGACGTAGTCGAGAGAGAGACCTCAAGCTAGGTTAACTAACGCGTTACGCCTAGACCTACGACAACGAACTCAAGCTCGGAGCAAGAGAAGGTTAGACGGCAACAACGCGAGAAGCGTCGCGTTAACGAAGTTCTAACAAGGAACCGCCGCCTAAGAATAGGAGCCGCAACACAC
Strand-82	ACATCCAACACTCTACGCCCAACGAAGAGAGTTAACTCAACGTCGGTAGTAGGTTACTCAAGAGAACCAACCTAAGGTCGACGTAACGAGAGTTCGGATCGTAGAGTTAGACGACCGTAACGACTCGACGCGGTACCTACTCGACTCTACCTAACGCCGAAGACGAACTAACGACGTAAGAAGCGAGAGACGCCGTAAGTCGGAACGAACGCGGTAGGAGGACGTAGACCGAATAGGAGCCGCAACACAC
Strand-83	ACATCCAACACTCTACGCCCAAGACTCGAGAGAGACTAGACGCTACCGTTCGCGCGAGTAGAGAACCTACTCAAGCTAGCCTAACGAGGTCGTAGAGGTTAGAAGGAGAGGAACAAGCGAGCTCGTCGAGACTACGAAGGTAGAGACCTAGTCGGAAGACTAGAGACTCGAAGAGACTACAAGGTTCGACGGAAGCGAGGCGGTTAACGACCGGTAGCGCCAAGACCAAGGAATAGGAGCCGCAACACAC
Strand-84	ACATCCAACACTCTACGCCCACCAACTACGCCGTAAGTAAGAACGTCCTCTAAGTCGGACCTAGCTAAGAGAAGTACTACGGAACTACTCTAAGTAAGTTAACCGAAGGATCGAGGTACGCTCAACCTACTACGACTACCGGATCGAACTAGTAGACGTACGGAGAACGCTAAGGACTAACCGTTAGAGAGACCGTCGGTAGCGCGAAGTTACTCGCTCTCAACGAACCTGAATAGGAGCCGCAACACAC
Strand-85	ACATCCAACACTCTACGCCCGAAGAGAGTTAACTCAACGTCAACAAGAGGAGCGGCAACGTCTCGTAAGGAACCTAGACTCAAGCGAGGAAGTACTAGTTAAGTCGGACGACTACGAACGTCCTAACGAAGACGAACTCTCTCCTACTCGGACTAACCTACGGAAGTAGGAAGAGAAGTCTCCTAAGGACTAGAAGGTTAAGGTTCGGAAGAGAGACGTAGACTACGTAAGAATAGGAGCCGCAACACAC
Strand-86	ACATCCAACACTCTACGCCCACTCGAGAGAGACTAGACGGTACCGCCGTAGAGACGAACTCGAGGAGGAGTAGCGGACTCGAACTAGAAGAAGTCTAAGAGTTCGTCTAGACTACGTCGAGCGTCCTCTAGACCGCCGGCGGAGACAAGACGAGGTTCCTCTAGTCGTACGAACTCGCGAGCGTCAACCTCTCGAGTTAAGACAAGAGAGACAACTACCTCAACCTCGCCGAATAGGAGCCGCAACACAC
Strand-87	ACATCCAACACTCTACGCCCAGTACGAGGTTCTACAAGAACGAACAACGCTACGGTCGGTCGAGTTACTACAAGTAGAGTTAGTACGGAGAGTTCGGACAACTAACTCCTCGAAGCGGAAGCGCTAGTTCGTTCTACGAGAGTTAACGCTCGTAGACGACCGAAGGTCTCGCCAAGTTCTACCTCGGTTACAACGGAACGTTAGACCTACGCAAGTCGAAGTAGTACGCTGAATAGGAGCCGCAACACAC
Strand-88	ACATCCAACACTCTACGCCCAACTACGCCGTAAGTAGGTAGAAGTACGCCAACTACCGTTAGAGACAAGGCAAGACTCTACTCCTAACCGTTAACGGTCGGTTAAGCGCCGGAGAGGAACAACTAACCTACTACGCTCGAACGAGAACGTTCGCTAGCCTCGGCGGCTCGAGCGGTTAAGACGCTAGAGACTACGCCTAGGAAGGCGAACGAAGCGCTACCGGTTACAACGAATAGGAGCCGCAACACAC
Strand-89	ACATCCAACACTCTACGCCCAAGAGTTAACTCAACGCCGAAGTCCTCTACAAGAGGAGGACCGGAAGTCTCGCCGGACAAGTCCTCGGTAGCGCGAAGAGCGCCGCTCTACTACGCGCTACTAGATCGAGGTAGAGGAACGCCGGCGGTCGGAGTACCTACAACCTACTCTAAGCTAGCTAAGTAAGCTCGAGCTAGAACTACGAAGTAAGACGCGGAGACTCTCGTAGTGAATAGGAGCCGCAACACAC
Strand-90	ACATCCAACACTCTACGCCCTCGAAGAGACTAGACTAAGCTACTACTAAGTAGAGCCTAGACGAAGGTACCGTACGCCTCGAAGCCTAAGTCTAGTTCGGCTACTAACAACGAAGAAGAACCGTACTACGACAACGCGGACTCGAAGGCTCGTCGACTACGAGAGAACTCTAAGCCAACGGAGACTACGAAGCTAGTACTAACAAGGAAGTCGTCTACGGACCTAAGAGAGAATAGGAGCCGCAACACAC
Strand-91	ACATCCAACACTCTACGCCCACGAGGTTCTACAAGACGAGTAGTTAGAGAGAGAGAAGGAGCGGCAAGAGAAGGCGGAGTTAAGAACGAGAGTAAGCTAGTAAGTTACGCCTCGCCGTCGGCCTCTCGTCGTAGAGGTTCTCGTAGTAGAGTACCTCGAAGAAGAGCGCCGCCGCCGGTAGAAGGCCGAGTAGATCGGAAGGTAGGAGACTCCTAACTAAGAGACAAGCGGAATAGGAGCCGCAACACAC
Strand-92	ACATCCAACACTCTACGCCCTACGCCGTAAGTAGGTAGAAGAACGCTCGAACGACGTCGTAGTACTAAGAGTAACGCTACAACGCGTACGCCGCTCGCGCGTACCGTTACGCCTACTACAAGAACAACGAACCTAGTACTCAAGGAGACGGTAAGGAACGCGCTAGAACGTTAGACAACGCGGAAGCTCGGACCTAGAGGTTCGCGTCGAACTAGACGTCGTTCAACGTCGAATAGGAGCCGCAACACAC
Strand-93	ACATCCAACACTCTACGCCCAGTTAACTCAACGCCGAACTAACCGAACGAGACGCCAACCTACGCGCGACCGCTACCGCGAAGACTCGAACCGGTACTAGAGACTAAGGAAGTACTAAGCGGAGAGAGACGAGGAACTCGTTCCTCAACGGAAGCAAGGAACGCTACGGCTACCTCAACAAGACTCTAACCGCGTCGTACGGAACCTACCTCCGTCTAAGCGCGTACAAGGAATAGGAGCCGCAACACAC
Strand-94	ACATCCAACACTCTACGCCCAGGTTCTACAAGACGGAAGAGTTAAGGACGAGCGTCTAGTTAACGAGTTCGTAAGGCGGTAAGTCGACGTTACCTCTACCTAGCTAGTAAGACTCGTTAACCAACGGCTCGACGTCGACGACTAACGCTCGGTCGACCAAGAAGGAACAAGGTAACTACGCGGAACGCGAACGCTAGAAGAGACGCCTAGACGTCCTCGTCTCGTTCGCGGAATAGGAGCCGCAACACAC
Strand-95	ACATCCAACACTCTACGCCCACCGTAAGTAGGTAGACTCGACCTCGGTTCGTCCTCGTCGCTAGAAGAAGTAGTTACTACAAGAGACGCGCTACGTACGCTCGCGCCGCGAGAACGTTCAACCTCCTCGGCAACTACCTCAACTAGTAACTACCTAGCGCGACTAGTAGCGCCGCGACGACCGCGGAACTACAAGACGGAAGTAGGTCGTTAAGGTACAACGCGAGTACTGAATAGGAGCCGCAACACAC
Strand-96	ACATCCAACACTCTACGCCCTAACTCAACGCCGAAGGTAGAAGTACGACCAACTAGGAAGCCAACTCGTACGAAGTCAACAACGGCGGAACTCGACAACTAACGAGTCGGAGCTAGTCGAGCAAGTTACGCTACGCGAGAGAGAAGAGTAGCTAGACCGCTACTAGTACTAGGTAAGCCGTACGAGGTTCGAGTTAAGCCGTCTCGAAGGAAGCTAAGTAGGAAGGTTAAGAATAGGAGCCGCAACACAC
Strand-97	ACATCCAACACTCTACGCCCAGACTAGACTAAGCCAACTCGACCGAACTCGAACGAAGGCGGTAACGCCTACAAGAAGGTAGGACTCTAAGCGTCCTCGGCGTCAAGAGCAACCTCGTCGTCGGTACGAGCAAGTACGCGACTAGGAGCGGCTCGTACAAGTTACTACTAAGAACTAACGGAAGACGCGCCTCGTAACGAAGACGCGAAGAGACTACCGCGTTAACCTCGGAATAGGAGCCGCAACACAC
Strand-98	ACATCCAACACTCTACGCCCTTCTACAAGACGGAAGACGCGGAAGCTCCTCTCGAAGGCGTCCTCCTCAAGTTCTAGACCGTCGGTAGAAGCAACGCTAAGACCGCGTAAGCGTCGAAGAGAACGACGACTCTACTAAGGTTACAACTCCTCGGCGCGAAGTACAACTACTAAGACTAGTTCGTCGCTCCTAGGAGGAGCGGACGCTCGACCTCCGAAGAAGAGTCGACCGAATAGGAGCCGCAACACAC
Strand-99	ACATCCAACACTCTACGCCCTTCGGTAGGTAGACTAACAAGAAGACGAAGACCGTAACCAAGAGCTAACGAGAACCTCGAAGCTAAGGCCTCAAGTACCTCGAACTACTAAGGAGGAAGACGTAGAGAAGGAGCCTACCTCGGTAGTACGCGAACCTCGTCGCGTAGAAGTCGAACTAGTCGAGAACCTAGAAGTTCGGCTAAGCCGTTCAACGCGCCGCGTCGACGACGGAATAGGAGCCGCAACACAC
Strand-100	ACATCCAACACTCTACGCCCTTCAACGCCGAAGGTAACCTAAGATCGAGGACGACGAGAAGTAGGTTACGAGAACAACGCTCGTTACAACGAACTAGGCGGTAGTAAGCCAAGAGGCGGCGCGCGAGGTACAACTAGTACCTAACGACCGCTCTAAGCGCTCGGAGGCGGCGGTTCTCGTAGGAAGACGCTAGGAACTCGAGGTTCGCTACGGAACAACAACTAACGGAAGAATAGGAGCCGCAACACAC
Strand-101	ACATCCAACACTCTACGCCCTTAGACTAAGCCAACAAGAACTAACTCGGCTAGAGCGCGGAAGAGAGTAACTCGGAAGGTAGGTACAACGCCGCCGGCCTACGCTAAGCGACTACTAGGACCTCGACCGCCGCCTCGAACCTCGCGAGCAACTAGTACGGCCTCTACTACTACTAAGCCGGCGTAAGCTCGAGTACTAAGAGCTCGCGTAGCTAAGGCTAGTCGTTAAGAGAATAGGAGCCGCAACACAC
Strand-102	ACATCCAACACTCTACGCCCTACAAGACGGAAGACGTCTAGTCGAACCTACAAGACCTAAGGAGCTACTAACTAACGGAAGGTACCTAACGAACTAGGAGGAGCGAACTCGCTAACGTCAACCTCTAGAACGCGTACAACGAAGGCTAACAACAACGCCTCTAAGACGGACTACGACAACCTACTAAGAGTTACAAGACTCGCCTAAGCGTCAACGAACGAAGGACGACGGAATAGGAGCCGCAACACAC
Strand-103	ACATCCAACACTCTACGCCCAGTAGGTAGACTAACGCCGCGTCGTTCAAGACTCGACTCTAACTAGAACCTAGAACCTACGTCCTCCTACCTAACGGTAGTAGAGAGTCGTAGGCTAACGGCAACGGACGCTCGAGGAAGAGGTACCTCGCGTCGAGTAGAAGACTAGACTAGTCGTTCCTACTAACTAGCGTCGGTACGTTACGCAACGCGAGACCTAGGACGACGACGGAATAGGAGCCGCAACACAC
Strand-104	ACATCCAACACTCTACGCCCAACGCCGAAGGTAACGAAGACTCGAGAACCGTCGCCGTAAGGAGTTCGAGAGACGCTCTACGAAGTCTAACCGGCTCGAAGAGTTAAGACTACGGCCTACCTACCGGCGTCAACCTAGAACGAACGAACGCTCGCGGCTAACTAGAAGAAGAGAAGACGACCGCCGCTAGACTAAGAAGTCTCTACGCCGTAACGAGGAGACAAGGTAGTGAATAGGAGCCGCAACACAC
Strand-105	ACATCCAACACTCTACGCCCAACTAAGCCAACAAGACTAACGCGTAAGGTACCTACGTCTACTAGGAAGCGAGATCGTCGACGAAGAGCAACAAGTAACTAAGAACTCCTAGGTAACTCAACTACGAAGCCGTCCTCGTCTAGAGGACCGTCGAAGGAAGGAGAACTAGTAGTAAGTCGTTACGATCGGAAGGAGAGACCTAGACCGTAACGTACTCGTTCTCGAGCGAAGAATAGGAGCCGCAACACAC
Strand-106	ACATCCAACACTCTACGCCCAAGACGGAAGACGTCGGTAACTACAAGTACTCGACGAGAAGAGACCTCGGTTAACTAAGTACCGTCGGTCTCCTACGAACCAACTACGTCGAAGACTAAGAGAACTAAGACGCTCCTACGTAGACCGCCTAGTTCGAACTAAGGTAGACCGTTAACTAGAGTAAGTTCTACGCCTAGACTCCTAGCGGTTCGGAACGACAACGACTCCTAGAATAGGAGCCGCAACACAC
Strand-107	ACATCCAACACTCTACGCCCAGGTAGACTAACGCCAACAAGAGTAGGTAAGCGTAACAACTCTAACTCTCGGAACAACTAGACTAAGGCGGTACTCGGAGCGTCAACGCTACGACGTTACGAAGTTAGAACGCGTTAAGACTACAAGCCAACGAAGACAAGTTCAAGACCGAAGCCTAAGGAACCGCGTCGAGACCTCAAGGTTCGAGTAACTAAGCCTAAGCGTTACTAGAATAGGAGCCGCAACACAC
Strand-108	ACATCCAACACTCTACGCCCACCGAAGGTAACGAAGACTCGAACTAAGCTACTACTCTCTACTACGGTTCGAGAACTCGCGGTCTACAAGAGAGGTTCAACTACTAAGGCTAAGCGAGGACGAGACCTCGCGCGAGACTAGAACTACGAAGGTTCCTCGTCGCCGAAGCCGCCTAGACTCGGTTACTCTACGGACTACAACGAAGAGTACGAAGCGTCCTCCTCGGTTAAGAATAGGAGCCGCAACACAC
Strand-109	ACATCCAACACTCTACGCCCTAAGCCAACAAGACTAACGCGAACCTAACGACGAGTCTAGACTACCTAAGGAACGCCAAGAGAAGGACCTCGACCGTTACGAAGAACTAACTCGAAGACTAAGAAGCCGGCTCGTTCGGAACTAGTACTACCGTAGAAGAGAGAAGTTACTAGACGACCGTAACTCTAAGAACTACTCCTACTAGACTAGGAGAAGCCAACGTCCTCGCTGAATAGGAGCCGCAACACAC
Strand-110	ACATCCAACACTCTACGCCCACGGAAGACGTCGGTAACAACGCCTACTCGAGCTAGACTAACGGCAAGACGAGGTAGAGATCGTAAGAGTAGACCAAGACTACCTAACAACAAGCTACGTACGGTCTACGAAGGACCGGAAGAACGTCGTCGACTAACTAACTAACGAACGTCAACGCGAGAACTCAAGGCGGACAACTCGGCGAAGAGGAAGACTCGTTAACTCTCGCCGAATAGGAGCCGCAACACAC
Strand-111	ACATCCAACACTCTACGCCCTAGACTAACGCCAACAACAACGAACTCGGAGAAGCGAGCGCCAACGCGTAGACGAACTAGACCGTTAAGACCTCGAGCGGTAGCGGCGCTAGTAACTAGAGGACTAGTAGCTACGGCTAGAAGACTACCGCTACTCAAGACGTCAAGGAAGTCGGAGACTAAGAGTAGAGATCGTACGCTACGACTCGCGCTAGCGAAGGCGAAGGCTCGGAATAGGAGCCGCAACACAC
Strand-112	ACATCCAACACTCTACGCCCGAAGGTAACGAAGACAACTAGAAGAGTTACGCCTAACAAGGCGCGGAACTCGAACTCTCGACTAAGTTCTACGAACAAGCCGCTCCTCAACTCGTCGGCAAGAGCTCGTAACTCGTCCTACTCTACTCGAAGACGTCGAGAACCTACCTAACCTCGAGTTAAGTCGGTACCAACCTCAACTACCTCAACGCGAGAGACGAACGACCTAGCGAATAGGAGCCGCAACACAC
Strand-113	ACATCCAACACTCTACGCCCACCAACAAGACTAACAAGACGAGAGAAGCCTAGACTAGAAGGAGACAAGGAAGTCGGAGCGGCGCCGTTCCTCGAAGAAGTAGCTACGAAGCTAAGTCGAGCGAACGAACGAGCCTAGAAGCGTAAGACAACGTCAAGTCGAACGTCTAGAGGTAGGAACCTAGAACTCGGAGGAGGTCGTACGGAGAGAGTCGGTAGAAGAACGGCCTCGAATAGGAGCCGCAACACAC
Strand-114	ACATCCAACACTCTACGCCCGAAGACGTCGGTAACGTCTACCTAACGAGCAAGACGACCTAGTAACTAAGGTAGTAAGGCGGAGAGACTCAACGAAGTCTAACTCGACCTAGGTTCAAGGAACAAGAAGTCTAGTAGGAACAACTCTCGTCGACCGTAACGTAAGAGTACGCTAACTAACCTAGGCGGAGTCTCGCGAACGCGTACTAACTCGCTCGGAGTACGACGTACGAATAGGAGCCGCAACACAC
Strand-115	ACATCCAACACTCTACGCCCAGTAACGAAGACAACGAACAAGTCGCTCTACAAGAAGGCTAACTAACGAGCTAGAAGTTAAGAAGGTACGGCAACTAGAGCGCGACCAACAACAAGTTAGAACGACTCAAGAGCGAACTACAACTCGGACTACTAAGCGGCTAGTAAGCGAGAGACGGACCTACTAAGAGTCGGAGCGCTACCTCGAGAAGGACCTCGACCGGCCTCGAAGAATAGGAGCCGCAACACAC
Strand-116	ACATCCAACACTCTACGCCCAACAAGACTAACAAGACCGAAGAGTTCGCTCGAAGGTAAGACTCGAGCTACGCTCGGAACGTCGCGAGAGAGAGAGACTAGAACGCCGGCAACAAGGCTCGGAGCGAACGATCGAGAGACGCGGAAGGTAACGCTAACGGTAAGTTCGCTCTAACCAAGACGTAAGGTCGGACTCAACAAGTCGCGACGAGACCTCGCTAAGGCCGTTACGAATAGGAGCCGCAACACAC
Strand-117	ACATCCAACACTCTACGCCCAACGCCAACAACGCCGCGAGTACTCTCGGACAACAAGAAGGACCTCGCTAAGGATCGTAGTACAACAAGACTAGGTACGAAGCCGTACGACTAAGGTCGAAGTACAAGTAGGAACCTCGACTCTAGACTCTCGAACTACGAACTCGCTCGACTAGTCTCGGCGCGAGCGTCAACGAACAAGACAAGAGCTCGTAAGTCCTACCTCAAGAAGAATAGGAGCCGCAACACAC
Strand-118	ACATCCAACACTCTACGCCCAACGAAGACAACGAACGCAACGGTAGTTCGTAGACGTAGAGTTAGAGACTAACGGAACAAGCGAGTTACTCGTAGTAAGGAAGGCGGAGTAACAACGCTAGCGGCAACGCGAGATCGAGGTTCGGTACGTAGTACTAACGACTCGCTACGACGAAGAACGCGAGTCCTAAGAAGAAGAGCGTCGAACTCTCGACGTTCTCGAGGTAGTTAGAATAGGAGCCGCAACACAC
Strand-119	ACATCCAACACTCTACGCCCAAGACTAACAAGACCGAAGAGAACGAACCTCTCTAACCTCTCGTCAAGTCGAGCTACGGAAGAACGAGCGAACTACTAAGGTAACTCAAGAAGGAAGGAGACAACAACGGCCTCAACGCCAAGGAAGGTCGGAAGTAAGAAGGCTACAACGCCGTCAAGTTAAGGAAGTTAGAACTCAAGAGTTAGTTCCTACAAGCCGTCGCCGCTAGAGAATAGGAGCCGCAACACAC
Strand-120	ACATCCAACACTCTACGCCCAGGAGTAACGTCTAAGCTAGGAACGCTAGGAGACTCGCCAACAAGAACGGAAGTCTAGACGCGAACCTCGTCGCGAGATCGAGGAGCGCGAACGAACTCTCGAGCTAGAGGAGAACGCGGAGAAGAGAGTAGACTAACTCGTACAACGGTCTACGATCGTAGTTAAGGTCGAGGACTAGTTCGACTCAACAACTACCTCCTAGGTAGGAAGAATAGGAGCCGCAACACAC
Strand-121	ACATCCAACACTCTACGCCCACCAACAACGCCGCGAGTACTAACGAACTCCTCAACGCCGTCGCTCTCTAACGAGAGTTCCTAAGTAGTTCGTCGACGGAAGTCTAGAGCGAAGCTCGCGGTTAAGGCGGAAGGAGCGGCTCGAACAAGAACTACGGAGAGTCGAGCTAACGAGACGCCAAGACGTAGACGTTAAGACGCGGTAAGACTCTAACGTTCCTCCTCTAAGCTGAATAGGAGCCGCAACACAC
Strand-122	ACATCCAACACTCTACGCCCGAAGACAACGAACGCAACGGTAACTACTAACTAAGGTCGTTCCTAAGTAAGAGGTACGAAGGTTAACTAACCGGCAAGTACGTCGTCGCGAGTACCTAGAGTCGGTTAAGGAGTAGGACTAGTAAGGAACGCGGCGAACCTCCTAGAAGTACCAACGGCTAAGCCTAGAGACTCTACCTCAACAACGGAACGACCTAGTAGAGCCTACTAGAATAGGAGCCGCAACACAC
Strand-123	ACATCCAACACTCTACGCCCACTAACAAGACCGAAGAGTACGCCAAGTAGTCGACCGCCGTAACCAACGAAGGTCTAGAACTCTCGTCGTTCTAAGAGTAGAACCTCAACGGCCTAAGAGAGTAGACGTCGTTACCTCGGTTAACGAACGCGAAGAGACAAGGCAACTAAGGTAGAAGTACTACCGAAGTCTCGTAACTCGGAAGCGCTCTAACTCGGCGGAACGGCGGCGAATAGGAGCCGCAACACAC
Strand-124	ACATCCAACACTCTACGCCCAGTAACGTCTAAGCTCGAAGTCGGTTACAAGAGTCGTAGAACGCGTAGAGGACTCAACAAGTCAAGAAGTACTACGGCTAAGGCGCTCGCTACGCTCTCTCGTACAAGACCAACTAACTCTACAAGGCCAACTAAGTACCTAAGACTACGACCGGTCTAACTAACAAGTAAGGAGACGCCAACTCGACCTAAGGATCGAGTCGGCGGACGGAATAGGAGCCGCAACACAC
Strand-125	ACATCCAACACTCTACGCCCAACAACGCCGCGAGTAGACGCAAGTTACGCCTACGACTACTCTCGGAAGTCGAACGCGCTAGACTCGCCAAGAAGAGGTACGAACTAAGACCTACCGGACTACAAGAGTCGAGGAACGAACGCAAGAACGGTCGGACCTACGGTACTCTAAGTAGGACCAAGGACGGTACCGGAAGCTCGACTCGCCTACTACGAAGAGACGGTAGACTCGAATAGGAGCCGCAACACAC
Strand-126	ACATCCAACACTCTACGCCCAACAACGAACGCAACCTCGAAGTCTAAGAGACTCGCGCGACTCGGAGAGACAAGGAACGAACGACTAGACTAACGACTCCTAAGTAGACTAAGTTCGGTTACGAAGAAGGAGACGCTAGGAGCGCCGCCGGAAGGACGTTAGAACCTACGTCGAGTTCGTAGTACCTACCTCAACAAGGTTAAGACGCGTTAAGGTCGAGGAGGACCGTCGAATAGGAGCCGCAACACAC
Strand-127	ACATCCAACACTCTACGCCCAACAAGACCGAAGAGTTCGCTACTAGTCTAGAACTAAGGTAACTCGCTCGGTTAACGAGAAGGTACGGTAGTTAACAAGAGTTACGAACGTAAGACGTCGCCAAGTTAGAACCTAGAAGCTACGAACGAACGACCTACGGCGGCGTCGGCGGCGCTAGGACCTCGAACGCGAAGAACCTCGCGAGGTTCAACGCGTAGAACGCCGCCGAAGAATAGGAGCCGCAACACAC
Strand-128	ACATCCAACACTCTACGCCCAACGTCTAAGCTCGACTAAGTAGTAAGTAGGAAGCGACTACGAGGAGACTAACTCCTAGGAAGAGACGCCTCGGTCTAGAAGTCGGTTACTACGTCGCTACGACGAGCCTCGGATCGAGCTACGCGAAGTTCTAAGAGAGGCGGAGAACTCTCAAGACCGAACTCAAGTTCGGTACGTACGAAGAGAGGAGAGAGTACGCTAGAAGCGTCGAATAGGAGCCGCAACACAC
Strand-129	ACATCCAACACTCTACGCCCAACGCCGCGAGTAGACGCAAGAACGTCGTCTAGTACGGCGCTCTCTAAGCCGGAAGGAGGACGTACTAGAGTAGGACCGCTACGTTAAGTACTACTACCGTCGTCCTAAGGCGGTTCGGTACCAACGGTAACTAACTCTCGTAAGTCAAGGAAGCTCGCTCGAGAACCGGCGGCTAGACGACGACCGTCCGTTAGAAGTAACCTAGGACTGAATAGGAGCCGCAACACAC
Strand-130	ACATCCAACACTCTACGCCCAACGAACGCAACCTCGAAGTCAACTAGAAGTAACGCTCGTAGACGTAACCTCTACTCGGAAGTTACGCGAACAAGAGGTCGACGTAGAGGAGGAAGTACCTACGCTCGTACGCTACTAAGAAGTACGTTACTCTCTCGAAGACGAGGAGCGCCGTCCTCGGAAGGCGGAACGCTAACTACAACTCGTTCGAAGGTCTCAACGTCGCGAGAGAATAGGAGCCGCAACACAC
Strand-131	ACATCCAACACTCTACGCCCAAGACCGAAGAGTTCGCTACTAACGGTTACGGTTCGTACTCGAACGGACTAAGACTCGGCCTCAACCTAGAGAGTACGAGTAACGCCAACGTCGGCTAGTCGTTAGACGGCCTCCTAACGTTCGGTCTAACCGCCGTTAGCGTCAACGGTCCTCCTCAAGGTTAAGGCGCTCTCTCGGAAGGTTAGTAGAGGTACGAAGGTAGCGGTTACGAATAGGAGCCGCAACACAC
Strand-132	ACATCCAACACTCTACGCCCAGGTAAGCTCGACTAAGTAGTAACGAAGCTCTCTAACGAACCTAAGGAAGACTCAAGAGACAAGCGTTAGACGGTAGCGTCAAGTCGTAGAGCAAGACGTTCGAACTAGTCAAGCGACAAGCTACCTAACGACGCGCGTCGTCGTAGGAACTAGACGCCGTTAGTACCTCGAGTAAGAGGAGTCTCGGCGGAAGGCGGTTACGATCGACCGAATAGGAGCCGCAACACAC
Strand-133	ACATCCAACACTCTACGCCCACCGCGAGTAGACGCAAGAACAACGCGACGTTCGAACGCGAACGCGGTCTAAGAGAGTAGACCGGAAGGAGGACGACGAGTAGTACGTTACGAACGACCTCGAGACCTCAACTCAAGTACGGTAGCTAGTAGTAGAGTAGATCGAACGAACAAGGAGACGCTCGGAGTAGGTAACTAGAAGGACAACCTAGTAGCTAGTCGACTAAGTTAGAATAGGAGCCGCAACACAC
Strand-134	ACATCCAACACTCTACGCCCGAACGCAACCTCGAAGTCAACAACTACGGACTCTACGAACTCGCGAGAAGAGAGACCGCCTCGGAACAAGTCGCTCGACCTAGTTCGACGTTAAGTCGGAGTTACGAAGAAGACGGACAAGACCTCGCTAAGACCGAAGGAACCAAGAGCTACGAACCTCCTAGTAGGAGGAGGAGGTTCGGAAGGAGATCGTTCGAACGAACCGGTTACGAATAGGAGCCGCAACACAC
Strand-135	ACATCCAACACTCTACGCCCACGAGTAGACGCAAGTCGTAGAAGTACCTACTAACGTACGGACTAGAACCTAGAACGAGACGCGAACGATCGACGTTCAACGGTTACCTCGGATCGAGACTACGCGCTCGCGCCTCGAGTAAGAAGTAACTAAGGAAGTACGGAAGGTCGACCTCGTCGACGTTAAGTAGTACCGTTCGGTTCCTCGGCCTCCTAACTCTCGGACTCTACGAATAGGAGCCGCAACACAC
Strand-136	ACATCCAACACTCTACGCCCTAGAACCTCGAAGTCGGAGAAGTCGCCGCTCAACCTAGGAGCAACGCGAAGAGTAGAACCGCCGTTAGGTAGTCGTAGACCAACTAGAGGTAGACCAAGACCGTCGTCTCGAAGTTAAGAACTAGCGCTCGAACCTCGTAGAGAAGACTACTCGTCTAAGCGTAAGCCGTCAAGTTACGCTAACCTCGGACCTCGACGTCGTTCGTCAACGAATAGGAGCCGCAACACAC
Strand-137	ACATCCAACACTCTACGCCCGAAGAGTTCGCTACTCTCGGTAAGTTACCTAACGGTTAAGGACGCCTCTCGAAGAAGGAAGGTAGGAAGTAAGGAGAGGAAGGAGAGTAAGCCGTCAAGGAAGGCTAGGAACTCTAGAGCGCCGGTAGCCTACTCGCTAGGTAGAGACTCAAGTAACTAAGTAGGTAACGAAGCGCTAACTCGTACGCGTCGACGTTCGCTCGCGGAAGAGAATAGGAGCCGCAACACAC
Strand-138	ACATCCAACACTCTACGCCCACTCGACTAAGTAGCCTCTACGGACGCGCCTAGTTCTCGTAAGGTTACTAACTCTCGAGCGAACTCGGAAGTTCGTCGACTCAAGAAGAGACTCGGTACTACCTCGCTAACGGTAGCTAGTAGAGTAGAACCGTTCTCGAACGCGGTCTCTACTACTCGTCGGAACGCAACGGCGAAGAGGCTCGGTTCGAAGGCTACGCCTCGTACGCTGAATAGGAGCCGCAACACAC
Strand-139	ACATCCAACACTCTACGCCCAGTAGACGCAAGTCGTTCGGTCTAAGGCGGCGGAGGACCGTAACCGCGTTCGGCGAAGTCGAACGACCTACCGTTACTAGGTCGTTAAGTCGGTAGTCGAGACCTCGAGAAGCCGGTAGCCTCGAACCTCTACAAGGCTAAGGAGGTAGACGCGCGTCGACGTAGTTACCTAAGAGTAACAACTACGGTCTACGCTAGAGGTTACAAGTCGAATAGGAGCCGCAACACAC
Strand-140	ACATCCAACACTCTACGCCCAACCTCGAAGTCGGACTCTAGAGCCTCGGCTAAGAGGAACAAGCGTTAAGAACCGGACTCAAGACTACTAGGACTAGTTCGAGCAAGAACCTCGGTCTAGAAGGTACCGTAACCGGCTAAGTCGCCGCTCGCCTCTAAGGCGGACTAACTAGCTAGGAACTCGCGAGGTTCTCGAGAAGGTAAGCGTAGTAGAAGAGCAACGGAGACGCGGAATAGGAGCCGCAACACAC
Strand-141	ACATCCAACACTCTACGCCCAAGTTCGCTACTCTCCTCTAAGTCTACCTCGCTCTCGGTTACGGACGCCTCGAAGGACGCGCGTCGACGGAACCTAGCCTACAAGCCTACTCGAAGTACTACAACAACCTCGGTAACCTAGAGACTCTACAACCTCCTCCTAACGGTACTCCTACTAGAACCGCTACTACCTCGAACTAAGACCGGTCCGAAGGTCTACCTAAGACTAGCGAATAGGAGCCGCAACACAC
Strand-142	ACATCCAACACTCTACGCCCTCGTTAAGTAGCCTCCTCGCGACTACTAGCGCTAGAAGAAGACTACCTAGTCTCCTAAGCAACTAAGGTAACTACAACGTCGGCTAACTCCTAGGCGGTTCGAGCGGAAGACCTCTAACTCGCCTACGACGCGGTCGGAGGACGTACTAACTCAACGCTACCGTCCTAGAGAGCGTCGCGTAGAGCTCTAGCGGATCGGAACCGACGTAGGAATAGGAGCCGCAACACAC
Strand-143	ACATCCAACACTCTACGCCCAGACGCAAGTCGTTCCTACCTAGTTAGAGTAGAAGTAACTACAAGTAGTTCGTCGGACGCCTACGAGACGCGTTAAGGTTCGTCCTAAGCGGTACTAAGTTAAGCGTCGGACTAACGTACAAGAGTAGAGGTAGATCGTCGAGTTACTAGTAGACTCCTAAGTCGCTCGGCAACCTACTCGCGTTCCTCGCCGGCGGCTACCTAGAGTTAGAATAGGAGCCGCAACACAC
Strand-144	ACATCCAACACTCTACGCCCTTCGCTACTCTCCTCTAACTAACCGTCGGTTAGTAAGGTCTACTCTACGCCGGTCTCAACGCGTCGTAAGGAACTCAACGAACTACCGTAGACAAGAGACGCTACGCTCGACGCGGCAAGAACGCTAGCGTCGCGTAACCTAGTACTCGTCTCGTCAAGTAAGAAGGACGCAACCTAAGTAGAGACGGCTCGTTCCTCAACGGCGGACTCGAATAGGAGCCGCAACACAC
Strand-145	ACATCCAACACTCTACGCCCTTAAGTAGCCTCCTCGGAGACCTCTACGGAGAGACCGCCGGTTACTAAGTCGGACGCAACGCGGAAGACTACAAGAGAGAGAGTCTCGCCGAACGCTAAGGACGCTAGAAGACGCGTCAAGGACGCGGTCTCCTACCTACGACTACGACCGCGAGACTAAGGACCTACTAACAACGACAAGCTAGAACCGAAGGTTACGCTACTCAACCTGAATAGGAGCCGCAACACAC
Strand-146	ACATCCAACACTCTACGCCCTAGAAGTCGTTCCTACTACGCTAAGCTCTAAGACTAGAGTAAGCCTAACGCTACGGAACGACCGCTAGAAGAAGTAAGACTCTAACCAACAACCTCGGAGAGAACGGCGAACTCTAGTTCGGACTACGAACTAGAACGACCGGCTACGCTCGGTCGACGACGAGTAACAACGGCCGGAGTAGGACCGCTAGTACGTTACAAGGTACTACTGAATAGGAGCCGCAACACAC
Strand-147	ACATCCAACACTCTACGCCCGAAGTCGGACTCTAGTAGAGATCGTAGACTACGTCGTTAGAAGGCGGTTAGAAGGAAGGAGACTACGCGAGTAAGAGTTAGTAGTCGAGCGGCGCGAAGAGGAAGAGGCGGAGAAGACCTACTAAGAGGTAACGCAAGAGGAGCTACAACGAAGACTAACTCTAAGCCGGCTACGGCGCCGCGTACAAGTCGTCGAGTACGTTACCTCGCGAATAGGAGCCGCAACACAC
Strand-148	ACATCCAACACTCTACGCCCACTACTCTCCTCTAAGAAGTCTCGAGACTAGAGTAACGCGGAGAGTTCTAGTACTACGCTCGGACGTAAGGCGTCGAACTAGAGAGGTACGGAGAAGCGAGCCTAGAACGCGCTCAAGAACCTACTAAGTACTACTACTACCTACTCGGTTACGCCAACCTAGACTAGACGAGGACGGAACAAGGACGCTACGAACTCGGCGGAACTAGAGAATAGGAGCCGCAACACAC
Strand-149	ACATCCAACACTCTACGCCCAGTAGCCTCCTCGGAACTACTACGTCGTCGAGAGACGAAGTCAAGTAGTACCTAACGAAGACGAACGCCGGCAAGAAGAGAACGAACTAACAACTCCTCGAAGAACCTAACGGCGGAAGTCGGTAAGCCGTCAAGTTCGGACCTCAAGAACTCGCTCGAAGTACCGGAACCGGAAGAAGGTAAGAGAGTCTCTAGAGGAGCTAACGATCGGAATAGGAGCCGCAACACAC
Strand-150	ACATCCAACACTCTACGCCCAAGTCGTTCCTACTAAGTACTAGCGCGTCGTACTCGAAGTTCCTAGAACGCCTCGGTAGTACGTTACCTAAGGAAGACGCGTTAACCTAGAGTCTACTACCTCCTCGAACCGCCGTCGAAGGATCGTAGTAAGGCCTACTCGAAGCTACTACTAGGTAAGGCTCGACGAGGAGGTAACTAGACTAGAGTAGCGAAGGAACCGCTAACGTCGAATAGGAGCCGCAACACAC
Strand-151	ACATCCAACACTCTACGCCCAGGAGACTCTAGTAGAACGGCGTCGCCAAGTTACCTAGTAGAAGACTCGTCGGTCGGTTCGTCCTCGGTTCGTACGAAGAGGAACGCGGCCTACGAAGCGCCGGCGCGTCGTTCGCTAAGACGAACGTCTAACAAGAACAAGGTAGCGGAAGCGTCAAGACGAGCGGTCTACTCTAGACGAGCAACAAGACTAGCAAGCGTAGTTAGAGAGAATAGGAGCCGCAACACAC
Strand-152	ACATCCAACACTCTACGCCCACTCTCCTCTAAGAAGAGAGGACTAACTAGAACCTAACGGAACGCTCGTCGAGGTTCGAAGAAGAGAGAAGAGAAGGTTCGGAAGCTCTCGCCGGCCTCGCCAACGCGACGAAGTAAGCCTAGAAGACCGCTCGGTTAACCGCCTAAGCCGAAGTCGAACGCTACGAAGGTAGTTAAGAACAACAACGAGAGACGAGAACTAGGCGGACCGAATAGGAGCCGCAACACAC
Strand-153	ACATCCAACACTCTACGCCCAGCCTCCTCGGAACTAGGACTAGTTACGCGTTCCTAAGAACGTTACTCCTACTAAGGCGGACGACTCGAAGAGAGTCGAGTAACGGTTCGTACTACGCTACTCGGACTAAGAGTAACTAGTACGGTAGAGAGTAAGAAGCCTAAGCCGGAGAGAAGTACTAGGAAGCTCCTAACTACCTAGAGTAGTTCTAGTTACTCGAACAAGAAGACGAATAGGAGCCGCAACACAC
Strand-154	ACATCCAACACTCTACGCCCTCGTTCCTACTAAGTACTACCGCCGAAGAGGAACCTCTAACCTCGTAACAAGGTTCGAACGTCGAACCTAACGGTTCGTTCTAGAAGTCGTAAGCTCCTCGCTAAGCCGTCTACTCGAAGTCGGAAGCCGTTAAGAGAAGGTTAACTAAGTTAGACGGCCTAAGTTAACCTCAAGGAACCAACTAACCTCGAACCTACGGTCGGACTACTGAATAGGAGCCGCAACACAC
Strand-155	ACATCCAACACTCTACGCCCAGACTCTAGTAGAACGGTCGGCGGACTCCTAGCAACGGAACTACGAAGTAAGAGTAGTTCGGACTCCTCGGAACGACGAGACCTACTAAGGAACGATCGACGTCGACGTCGAGCGGCGGCAAGTTAAGTTACGCGTAGTTACCTCTAACGAAGAACCTACGCCTCGGAAGTAGACGCTAAGCTAGTTACCTACGAGACCTCGTCGGCAACGAATAGGAGCCGCAACACAC
Strand-156	ACATCCAACACTCTACGCCCTTCCTCTAAGAAGAGAAGACCGCTAGAAGGAGGTTCGGCAAGTTACGCCTCAAGTAAGCCTAAGGACCTCGCTCGAACAAGTCGTACAAGGAACGCCTCTACGCGACGTTCCTCGGTCGGAGACTCTCGAGAAGAACGGAACAACGAAGACCTCTCTAGAGTAGGAACGCGTACCTAAGCGGTAGTTAAGAACAACAAGGCAACTAAGCGGAATAGGAGCCGCAACACAC
Strand-157	ACATCCAACACTCTACGCCCTTCCTCGGAACTAGGAGGACGTAGTTAGAGAACTAAGACGCCGTCCTCGAAGGATCGTTCGAAGACGAAGGTAGTACGACCAAGGAACTAAGCGCGTAGACGTAAGGTCTACTCGTCTAGAGGAAGAACTACGTCCTCTACGGACTCGAACAACAACTAACGTTAAGGTACAAGTTAACCGCGTAAGCGAGGTCGTTAGAGGAAGCCGTTGAATAGGAGCCGCAACACAC
Strand-158	ACATCCAACACTCTACGCCCTTCCTACTAAGTACTACTAAGTTCGGCGCTAGCAAGAGAACGTACCTAAGCCTCGGACTCAAGGAACAAGGCAAGTTACTCGGAGAAGTCTAACTCTACGCCGAACCTCTCTAACTCGCTCGATCGTACTCGTTCCTCGTCAAGTTCGAACAACCTCTAACGAGAAGCGCCGCGACCGCTAACGCCTACGGATCGTACTACGCTCTACTAGAATAGGAGCCGCAACACAC
Strand-159	ACATCCAACACTCTACGCCCTTCTAGTAGAACGGTAGTCTCTAACTACGCGGATCGAGTACCGAAGTCGCGTTAGAGTTAACGAACTCGACCGGCTAACTAACGTTAACTACTACTCTAAGTAAGAGGCGGACTCCTAGCGCGTACGGCAAGACTCGCTCGTTACTAGAAGAGAGTTAACTCGGAAGTTCGTCGAGAACCTAGTAGACGACGTTAGAGTAGAAGTTCCTAGAATAGGAGCCGCAACACAC
Strand-160	ACATCCAACACTCTACGCCCTTCTAAGAAGAGAAGAAGTCGTCGAGTACCGGCGGTAGCGGACCTAAGAGTTAGTCGAGGAGTACGTACGGACAACGCGAAGAACGACTCAAGGAAGACGGAAGCCTACTCAACGGACTCGCCTACGTCCTAACGAGGTACTCGTAAGCTAACGTCAAGTAAGGAAGGTCGAGAGAAGGTAGACAAGCTCTACGCGAAGGTCTAGAGTAAGAATAGGAGCCGCAACACAC
Strand-161	ACATCCAACACTCTACGCCCTTCGGAACTAGGAGGAGGCGGTCGACGAAGACTCTAGACCTCGGCGGCAACGGATCGAGTTACCTCGGTAAGAACAACGAAGAAGCTAAGAGTCGGAGTCTCTCGTTAGAACTCTAGTCGAGACTAAGCTACGGAGAAGCCTACGTCTCGACGTTCTAGTAGAACGTCGAAGAAGTCGGCCTAAGCTCGAACTACGGACTCAAGACGTAAGAATAGGAGCCGCAACACAC
Strand-162	ACATCCAACACTCTACGCCCTTACTAAGTACTACTACCGGTTCGTACTAGTAAGCGACGTTAAGCGCTAGTAGACCTCAACTACGCGCTCGCGAACCTACCGTACTCTCGAGCGTCTCGACCGAACTCGAACTACAACAAGGTAGCGCCGTCTCGAGGAGCCTAAGACAACCTACCGGTAGAAGATCGACCGCGAGAGAGTACTCGTACGCTAGGAAGACCGTCTAAGTCGAATAGGAGCCGCAACACAC
Strand-163	ACATCCAACACTCTACGCCCTAGTAGAACGGTAGTTAACCTCGAAGTTAAGCTAGGTAGTTAAGAACGACCTAACTAAGGTAGAGTTCGAAGACGTTACTCTCGACGAACAACGCTCGACAACCTAACGCTAGCGGTAGTACCTAAGGCTACGAAGAGTTACGCAAGACGTACGAACGCTAGTTCCTACAACTAAGCGGCGCGACTCTCTCGAGCTAACTAACGTAGACGGAATAGGAGCCGCAACACAC
Strand-164	ACATCCAACACTCTACGCCCTAAGAAGAGAAGAAGAGAACTCGAACGTTACCTAACGTCGCCGTTCAAGTCTAGTTCTACAAGTTCAAGACGAGCGCGACGACGTCGTTAGAGAAGTTCGCCGGCGTCGCCGAAGGTTAACGCTAGTACGGCTCGACCTACAACGGTCTCTCGAGAAGGAGCTAACGCCTCCTAAGTACCGGCGCTCGCGTCCTACCTAACCTCTCGTAGGAATAGGAGCCGCAACACAC
Strand-165	ACATCCAACACTCTACGCCCAGAACTAGGAGGAGGTTAACTCGACTCGGAACTAGCTAACTAGAAGCTAGTCTCTAAGTCGGAAGCTCGTTCAACAACAACGGCGCTAGCGAACTCCTAAGAGACTCGAAGTAAGCTAACGAACGACGCGGCAAGAACGTCGAACGCGCTCGGCGGCGGACGTAAGCGTTACTACCTAAGTAGTAAGAGTCGAGCCTACCTCTCGTCTACGAATAGGAGCCGCAACACAC
Strand-166	ACATCCAACACTCTACGCCCTTAAGTACTACTACCTACGGTACGACGAGTTAAGCCTAGAAGTAGTTAAGCGTTCGCTCGAAGAACGGCCTAGAGTTACGCAAGAGACTACGCGGACCTCGAGTTCGCGGACGCGAAGGTCGGCGGTAACAAGACGTCAACAACGGTAGCTACGAAGCGTAGACTACGTTCTAAGGCGGTACCGTACTCGCCTAGTAAGACCTAAGCTAGGAATAGGAGCCGCAACACAC
Strand-167	ACATCCAACACTCTACGCCCTAGAACGGTAGTTAAGGCTACGGCGGTAGACGCTACGCTAAGAACGCCGCTACGAGACTAAGACTCGCTAGGAGAAGGAGAGACGTCCTAGAAGGTACCGCGAGCGGAACGACCGGAAGCGTCCTACAAGAAGCGTAGTAACCTACGAAGTACGGCAACGGTAGAACTAAGAGAAGGACTAACGGACTACAAGTCTAGTAACTACAAGCGGAATAGGAGCCGCAACACAC
Strand-168	ACATCCAACACTCTACGCCCACTAGGAGGAGGTTAACGACGTAAGACAAGACTCGAGACGGTTAAGGAGAGTTACAAGAAGCGAACGAAGTCAAGAACCTCCTCCTCGTCGGCAAGAACTACGGCGAAGACGGACCTAGTTACCTCGCGACTCGCGCCGTAAGCGCCGAAGGTTCGGAAGAAGACGTCTACGTCCTCGTCTACGCTAGGAAGTACAAGTACAAGAGTAACGAATAGGAGCCGCAACACAC
Strand-169	ACATCCAACACTCTACGCCCAGTACTACTACCTACTACTAGACGTAAGGCGTCTCGTCGAAGACCGGTAGTAAGAGCTACGCGAGCAAGTAGAACGTCGGATCGAGGAACTCGAACGCTCCTAGGTTAAGGACTCGAGAACTAGAAGCGAGCGAAGTCTACGGCGGCAACTAGACCGCGAGAAGGCGTAGTAGTTAGAAGAGGACGTAGAGCGCGAACAACCTCGGAGAAGAATAGGAGCCGCAACACAC
Strand-170	ACATCCAACACTCTACGCCCAACGGTAGTTAAGGCGGCGCGAGCCTAGAGACCTAAGCCGTCGAAGCTCAAGCCGTCGCCGCCGAAGTCTAAGAGGCCTAAGTCCTAAGTAGCTAAGTCTCGAGTTACAACGCCGTCGGAACCGAAGGAACTCTAGACTAGTTCCTAGAACGAGAGACCGTCGAACCTCCTCTAAGGACCGGACTCGCGTAGAGTAGAAGTAACTCCTAGGAATAGGAGCCGCAACACAC
Strand-171	ACATCCAACACTCTACGCCCAAGAAGAAGAGATCGAGGTAGAGGACTAGGTTCTAAGAGAGTTCGTTCGTCAACCTCCTCGCCTACGGCCTCAACAACCTAAGAAGGAGGAACGAACCTAGTAGCAAGGAAGCCGGACAAGTCAACTAACGATCGAGAAGGACTAACCTACAAGCTCGACGCGCCGGTAGGACGAGGAAGACGAAGTTACGCAAGTACAAGTTACTCGAAGAATAGGAGCCGCAACACAC
Strand-172	ACATCCAACACTCTACGCCCAGGAGGAGGTTAACGACCGAAGCTCGCGGAGAGACCTAACTCTCGAGGTACCTCCTCGGAGACCTCTAAGGTCTAACCTACGGCAAGAACGGCTACGGAACTCGACAACAAGCCGGAAGCCTCGCCTAAGCTCAAGGAAGCTAGAGTTCGAGTTACGGACTCGCCGTTCGCGGAACTAAGTTAAGGCGGACGAAGAGACAAGACAAGTTAGAATAGGAGCCGCAACACAC
Strand-173	ACATCCAACACTCTACGCCCACTACTACCTACTACTAAGCTAGTAGTAGTAGTAGCAACGCTACGAACGAAGAAGCCAAGACCTAGAACGGATCGTTACGCTACGGCGCCGGAACTCGGTTACTCAACTAGACTACTAGAGAGAAGACTAACTACTAGACTCGTTACAAGAGTAACCTCTAACGACGCTAGTACGGAAGACCTACGACGACCGCCGGCAACAAGAGCCTCGAATAGGAGCCGCAACACAC
Strand-174	ACATCCAACACTCTACGCCCAGTAGTTAAGGCGGCGCGAGCAACTAAGGAACGTCGTTAAGAACGAACTAGAACGTCGGAACTAACGCTAAGGAACGAGACAAGAACGGTAGGAGAAGCGCCGTCTCGAACGTCTAAGAAGAAGACGAAGTCTAAGACGGACGCTAGTACTACCTACGCGGCTCGTACCTCGGTACTCTAAGAGAAGGTCTAAGCAACGAACTCGCCGCTGAATAGGAGCCGCAACACAC
Strand-175	ACATCCAACACTCTACGCCCAAGAAGAGATCGAGGTAGTTAACCGGACGCGCGTCGAGCTAAGAAGACAAGACCGTACGAGAGTAACAACTACGCGGCGCTAACGGTACGAGTCTACTACGCTAAGACTCGTCGAAGAGTCGGAGTACGTTAGACGAACTACTAAGGTCGTCGAGTTAGACGAGCGCCTCGAAGTAGAGCGTCGGCGTCGGCAACGAACGAACTAGTAGAGAATAGGAGCCGCAACACAC
Strand-176	ACATCCAACACTCTACGCCCAGGAGGTTAACGACCTAACCTCGGACGTTCGGTAACCTCGAAGCTCAAGAACAAGCGAACTAGAAGTACGGTTAACGCGGACCTCTAACGTTCGAAGCGTAGTACTAAGGCGGCCAACCTCGGAGTAGACTCGGTACCGGCTAACTAAGACAAGACAAGTAGAGCTAAGAGTACCTAAGGTACTAGTAACGACTCTAGTTACAAGACGGCGAATAGGAGCCGCAACACAC
Strand-177	ACATCCAACACTCTACGCCCACTACCTACTACTAAGGAAGCGCTACCGCGAGATCGTCGTTAAGACAACTACCTAACGTCGGCAACGCGAACGCGAGCGTCTAGAGAGACGGCTAGACGTACTAGAACTAGAACAACGGAAGGAACTACAACGGAGAAGTTAAGAGAAGGTAGTTAGAGACCGCTAGAAGACAAGACGGTCTCGCTCCTAGGACGAGCGGCAACGTCCTCGAATAGGAGCCGCAACACAC
Strand-178	ACATCCAACACTCTACGCCCAGTTAAGGCGGCGCGTTCGTCGGTTACGGTAGCGTCAAGACCGGTTACGGCTACCTCGGCTCGAGACAACCTACTCAAGTCTAGTTACTCAACGGTCTCGCTACTACTAGTAGACAACGCTAAGAGAGACTCAAGTAACCTACGTACGCGAACGCGACCGAAGCTACCTAGACGGAACAAGGCGTCAAGAGTTAGAGAGAAGAGTCGTTAGAATAGGAGCCGCAACACAC
Strand-179	ACATCCAACACTCTACGCCCAAGAGATCGAGGTAGTTAAGCGCCGGACTCGCCTAGACTCAACTCGCGTTCCTCGGTCTACCTCTAAGATCGAGCGTCGGCTAGGCTCAAGGTACCGTCCTAAGCGTCGCGAAGAGGTTCGGCAAGTTCTACGTCCTAACTCTACAAGCCGGAGAGTCGAAGACGAAGACGAGAAGCGAAGACGGCAACTAAGGTAAGAGTCAAGCGAGGGAATAGGAGCCGCAACACAC
Strand-180	ACATCCAACACTCTACGCCCAGGTTAACGACCTAACGCGTCGAAGCTACTCCTCTACAAGGTAGTAGGAGCCTAACGTAGAGGAAGAAGAAGACTCGAAGAGACGGTTAAGCGAGTCTAACTCAACTCTAACGAGAGACCGCGTAGAGTAAGGAAGCGTCGTCGACTACTCAAGTCGCGTAGTCGTTCTCGACCAAGTTCTAAGGAGAGGAACGACCTCGCCTACGAGAAGAATAGGAGCCGCAACACAC
Strand-181	ACATCCAACACTCTACGCCCACCTACTACTAAGGAGAAGCCGCTAGGTACAACGCTCAAGCCGGAACGTAGTACGCCTAAGGAAGCCTAAGGTACGGTAAGAAGAGAAGGAGTTAGTAGACCTCGAGTCTAACTAGCGGTTCGAGAACGAGCTAGAGCGCCAAGAACGCGTACCAAGGAGAGGCCTACTACGCTAACGGCGCCGGACCTCGAAGGACCAACGTCTAAGAGGAATAGGAGCCGCAACACAC
Strand-182	ACATCCAACACTCTACGCCCAGATCGAGGTAGTTAAGCGGCGCCGTCGTCCTCTCGAAGTTCAAGTTCCTCAAGTTCGCTCGGACTCCTAACAAGGAAGGCTAACCTCGAACGAGCGGACTAAGTAGCGCTACGAGTTACGAAGCTACTCGCTAACGACAACGCGAAGCCAACTAGTAACCTAGTCTAACGTACCTAGAGAACAACAAGTAGTAGAACGGACTACCTAGAGAATAGGAGCCGCAACACAC
Strand-183	ACATCCAACACTCTACGCCCTTAACGACCTAACGCTCGAGGCGGAACTAAGCGAGACCTCGGAGGAGAGAGTTCGCGACCGTTCGGTTCAAGTCGAGTTACGAACTACAACCTAGCGGTAACCTAAGTAGTAGTAGAACTACTACGAACGCCGCTCGGAAGAGCAACGGCGTCGGTCTACGCGGAACTACTCTAAGAAGCGGAACTAGGTTAAGCGGACAACTCAACTAGGAATAGGAGCCGCAACACAC
Strand-184	ACATCCAACACTCTACGCCCTACTACTAAGGAGAAGCGAGCAAGAACAACCTAAGAGAGGAAGGTTACGGTAAGAAGAACTACAACTACTAGAACGAACGAAGGAGGACTCTAACTACGTTCCTACTACCTCCTAAGTAGAGGTACGAAGAGAGCTCGACTAGCTCGAGACTACCTAGACGCGGACGCGCCGTTCCTCGGAGAAGAAGGTAGTTAGAGTCGACTCCGTTAGAATAGGAGCCGCAACACAC
Strand-185	ACATCCAACACTCTACGCCCTCGAGGTAGTTAAGCTAAGACTAACAACGCTCGAAGACTCGAAGACAACGCGCCGCGGAACCTCCTCGGAGACCTCTCCTCTACGGAAGAAGGAACCTCTCGAACCTCGGTTAAGCCAACTCGAAGAGATCGAGCCTCGAAGCCGGCGTCTCGTTCCTAAGAACTAGCTCGTTACAAGAGAGACAAGAGTCGAGAAGAAGTACTCGAGACGAATAGGAGCCGCAACACAC
Strand-186	ACATCCAACACTCTACGCCCACGACCTAACGCTCGACGAAGACGTAAGCCGTCTACGAAGTCAAGAGACCTAACTAAGGCGAAGCGACGAAGGAAGTCTAACGCCTCTCGTCGAGCGCTACCAAGACGACTACTCTCGTCTAAGAAGGAACCGGACAAGACGCTAGTTACAAGTAACCTCGAACGTTAGAGGAACTCTACGGCGTCGCTACCTAGACCTACAAGTTCGCCGAATAGGAGCCGCAACACAC
Strand-187	ACATCCAACACTCTACGCCCTACTAAGGAGAAGCGTACGTCTACAACGGTAGCTAACAAGCTACTCGCAACAAGAACGGCGAACCTAAGTAGACTCTCTAGTAACTAAGCAACGTCAAGAAGAGAGAGTTACGAAGAGAGTAGGCTCTCAACAAGTTAACTCGGAACTACCTAGAGAACCTACGAGAAGGAACCGGATCGAAGAGTCTCAACTACGGTTACGCTCTAACTGAATAGGAGCCGCAACACAC
Strand-188	ACATCCAACACTCTACGCCCAGCGCGTTCGCTCGCGGTAGCTAGAGAAGGACGAACGCGAGTACGAGTCTAACCTAGAAGTACTAAGAAGAGTACCTAGAGGAGTTCTCGACGTTCAACGCCGCCGTCCTCGAAGAACGCTAACAAGGTAACCTACTAGACGAAGAAGACGGTAGCGTCGCTAGTCTACGCGCGTAAGTCGTCCTACCTAAGAGTACTAGTACGTTCTAGGAATAGGAGCCGCAACACAC
Strand-189	ACATCCAACACTCTACGCCCAGGTAGTTAAGCTAAGAGTTCCTCGTCAAGAGTAACGCTCAAGCTCTACAAGGATCGAAGACCGCGAAGTAGTCGTAACTAGACTAAGGTCTCTCGAACGGCCTCGTCGCTCGCAAGAGAAGATCGTCGAGACCTCTCCTCCTACGCGGTACGACCGGCTAAGACTAGAGACAACGCCTAACCTCGACTAGGAGGTAAGGCCTCGGTTACGAATAGGAGCCGCAACACAC
Strand-190	ACATCCAACACTCTACGCCCACCTAACGCTCGACGTCGTTCCTAGACGCTAGCTAGTACGCGTAGAGCTCGACTCGGTAGTAACAACCTAGAGACTCGAAGTTAGAGTAGTCGTTACTAAGCAACAACTAGAGGAGAAGCGGTCGGAAGAACGGAGAAGTCGGACGGACGGAAGCGAGCGTCGAAGCCGCGACTAGAACCGAACCTAAGACGTCGAACAAGAGAAGAACGGAATAGGAGCCGCAACACAC
Strand-191	ACATCCAACACTCTACGCCCTAAGGAGAAGCGTACGGACTCTACGGAGAGTCGACGAACAACCTCAAGTCGTTAAGAAGAAGTACCGCCTAACCTAAGTACGGCGGAACTAGCGTCCTCCTAAGGTAAGTCGGACTACCTAAGGAACTAACTAGTACCTAGACGACCGCGAGCTACTAGGAACGACGCAAGTTCCTAGGCGGAGCTAACGGAGACTACGTTCCTAAGTTAGAATAGGAGCCGCAACACAC
Strand-192	ACATCCAACACTCTACGCCCACGTTCGCTCGCGGTCTCTCGTAGTCGTAACGACTACGCCTAACTCAACTCTAAGGTCTCGGAACGAGGTAGACTAGCAACCTCCTACGCGCTAGCGCCGTTAGAAGACTAGAAGTCGTCCTCTAGTAGTAAGGAGAGTACGAAGAAGACGCTCAAGCTACCAACGTCTACCTAAGCGGAAGGACCGAAGCTCTACAAGACCTAAGGAACGAATAGGAGCCGCAACACAC
Strand-193	ACATCCAACACTCTACGCCCTAGTTAAGCTAAGAGTTAAGAGAACCTACCGGTACGTTCTCGAACTACTAGTCGAGCGGTAGAAGGTAGTAGAGGAAGTACCTACGCGGCTACGGAAGCTACGGACGCAAGAACAAGTAGAGTAGAACGACTCTCTCGAGCTAGAACTACAAGTCGACCAACGGACTCTCGAGAACGTCGAGGTTAAGCGTCAAGGAAGGTAAGGAAGAAGAATAGGAGCCGCAACACAC
Strand-194	ACATCCAACACTCTACGCCCTAACGCTCGACGTCGTACTCGAAGTCGTCGACGTTCGCCGTACTAAGTACCGCTCAACGAAGTAGTACGAGGTACCTACGAACTAACGCCGTACGAACCTAAGAAGTCGGACCTAGCGCCGTAACCAAGAGCAAGACTCGCTAGACGTTCGCTCTCAAGACCGCCGGTAGGACCGTTAGAGTAACGTCGTAGAGACGCTCGAACGGAGACGAATAGGAGCCGCAACACAC
Strand-195	ACATCCAACACTCTACGCCCTTCGCTCGCGGTCTCAAGACTCTAACGACTACGTACTACCTCTAGTAGAGCTCGTTAGAGTTAAGCAACCTAAGCTACTAGACCTACGGCGGTAACAACGAAGGAGAGAGTCTACCTAGGAGACCTAGACTACCTAGTTAAGAGTTACCTCTAAGATCGAACTACTACGGTTAGAGCTACGTCTAAGAAGCGACTCGAACTCGATCGTAAGAATAGGAGCCGCAACACAC
Strand-196	ACATCCAACACTCTACGCCCTTAAGCTAAGAGTTAAGGACCGGCTAGACGACCGGTAACGAAGACTACCTAAGGTAGAGTTAACGCTAAGAAGCGTAAGAAGAGTCGAGCGGAAGGTACAACAAGAGAGAGTCGACCGTCGGCCTCTAGTTCGCGTACGAACTCTAGTAAGCGTAAGGCCTCGCTCCTACGAGCGGCTAGTTCGCCTAGTCGACGAACGGAACCGCGACGGAATAGGAGCCGCAACACAC
Strand-197	ACATCCAACACTCTACGCCCTAGTCGACGTCGTACGCTAGAAGAGAGTTCGAAGCCTCGAGGAGGACTACTAGGAGTACGAAGAGAGAGTCGACGAGGCGGACTACTAGTACTACCAAGTTAAGGTAGTAGTTAAGAAGGTAGAAGAAGTACTACGAAGCTACGTTCGCGAAGTTCTAGTAACTAGAGAGAGACAACTACTAACGCGAAGAAGGCTACGCCGCGAACGGTGAATAGGAGCCGCAACACAC
Strand-198	ACATCCAACACTCTACGCCCGAAGCGTACGGAAGTAGTAGGTAAGCCGTCGCTACTAGACCTCGGTTCTAGAGGACGTAGTACGGACCTAGTTAGAAGAACGTCGCTCGCGTCTAGTAAGCTCGCGAAGGTAACGGCAACAAGTAGAGGTCGAGAGAGACGTTAGAGTTCCTAAGCCTAAGGAACGGTACTCTAGACGTCAAGTAACAAGGCGCTAACTAGTACTCGACCGAATAGGAGCCGCAACACAC
Strand-199	ACATCCAACACTCTACGCCCACTCGCGGTCTCAAGAACGGCTCGACCTACTAGAGTCTACTAACGTAGACGACTCGGCGGTAGTAGAGGACGAAGTCGTAGAGTAGGACTCTAGACGAAGCCGCGAAGTACGTCGGTAGTAAGACTAGCGTCCTCAACGGCCGAACGTTCGGCGCTAGAAGACAAGTCGTCGCCGCGGAACAAGTCAAGTAGAGTCGGTAACGCGTACTAGAATAGGAGCCGCAACACAC
Strand-200	ACATCCAACACTCTACGCCCAGCTAAGAGTTAAGGAAGAGGACGAACGGCGCTAGAGACGCTCAACTAAGTCTAACCTAGAGCGGACCTAGGTTAACTCTCTCGTCGTAGACCGCCGTTACTCCTCCTCTCGCGAGGTTCTAGGAACGAAGTCTAAGCCTAAGACGCGGAACCTAACGCAAGACCGTTAGGTACGTCTAGAGAACCGCCAACGCCGGAGACGCCGTTAGAGAATAGGAGCCGCAACACAC
Strand-201	ACATCCAACACTCTACGCCCTCGACGTCGTACGCTAGGAGTAGCGCTCGGACCGCTCGCGTCTAGAGCAACCTAAGTCTCCTACGACAAGCTCCTCTACAAGGTCTCTAAGAACGCTAGAACGCGGAACGCAAGGAACGATCGTCGACGTAGGAAGCGTAGGAACTCGTCAACTCGAGCCTCGGTAGTACTAAGAAGTTACTAAGTCTAACCTCGAGACTCGTCTAAGGCGAATAGGAGCCGCAACACAC
Strand-202	ACATCCAACACTCTACGCCCTAGAGTCTCAAGAACGAAGTCGCTAGCGCTCGCTAAGCTAACTAACAACGCAACGCTCGGAGCGAACTAGACAAGTTCGGAGACGCTAGAGAAGGCAAGTCGACGTTACGACTCTAGTTACGCTAGTAGAGTACCGCTCAAGAGAAGTAGAAGAACAAGTTCAACGAACAAGCGAAGACGACCGGCGCTAGTCAACAACGCCTCGCGTCGGAATAGGAGCCGCAACACAC
Strand-203	ACATCCAACACTCTACGCCCTAAGAGTTAAGGAAGACTAGTTAGAGCAACGGTAGCGGCGGCGGTAGACTAGAGAGGAGGAAGACCTAGTAGTAGTCGAGCGCGAGCGAAGAACGCAAGACCTACTACGCCGAAGACTACTAACTCGGCTACGCTCGACAAGCCGCGTTAGACGGTAGTACGTAGTAGCGAAGTACGTTAGAGTAGAGTAGAGACGTCCTAGAGTTCTACGAATAGGAGCCGCAACACAC
Strand-204	ACATCCAACACTCTACGCCCACGTCGTACGCTAGGAGCTAGTTCGAAGGCGTCGCTCTCGAAGGCTAGAAGACTAGGTTACAAGGTAACGGACAACCTCAAGAGACTCTCGGTCGGACCAACAACGAACGAAGGAGGACGTTCGGTAGCCTCTACAAGTACAACTAGTAGACCTACAACGGCCTAAGCTAGACTCGCGTCTCGAGTACCGGAAGGACCTAAGCCGCTACGGAATAGGAGCCGCAACACAC
Strand-205	ACATCCAACACTCTACGCCCTACGGAAGTAGTACCTCGTAACTAGACCTAACGACTAGGACGACTACCAAGGAAGGTACTCCTAGACTACGAAGAACGTAGTTACCTAGTTAGTACTAAGCGAGGTCGAGATCGAGGACCAACTAAGCGGTCGCGAGTCTCTAGTACAAGTAAGTCTAGTTCCGTCGGAGGACGAGTTAACGACAAGGTTAGACCGCCGGCCTACAAGCTGAATAGGAGCCGCAACACAC
Strand-206	ACATCCAACACTCTACGCCCAGTCTCAAGAACGAAGGACAAGGCGCGTCGTCGTTCAACTCGTACTCGAACTAAGGTTAGTAGACTCGAAGGTCGGAAGTCGAAGGTAGGAGCAACGGTAGGAACGCCGCTAGAAGGAGGACCAAGAAGTACCTACGAACCGCTAGGACTAGAAGGTTCGCGTAGAACGCTAACTAAGTCGTCCTCCTCTAAGGCGCTACTCGCCTAAGTGAATAGGAGCCGCAACACAC
Strand-207	ACATCCAACACTCTACGCCCAAGTTAAGGAAGACTCTCTAAGGACTCAAGAGAACGTACAAGTACGGTACTAGCCTCTACTACGGCAACGGTCGGCGGTACGCGACTCTACGCGCTAGGTCGTTCTAGACCAACGCTCTAGACGGTTAAGGTACGTTCGCGAGTCTCCTAGAAGGCTAGAGGACCTAAGGTCTCTACCTAACGTAACTACAACGAAGTCTACCTAGAAGAGAATAGGAGCCGCAACACAC
Strand-208	ACATCCAACACTCTACGCCCTCGTACGCTAGGAGCCTCGCGTTACAACTACAACCTCTCTAGAGCTAAGAGACGACTACCTAGTAAGGCGGTACGAACTCGTACGAAGCGTACTAGAGTCTCAAGAGAGAAGGACTACAACTCGCTAGACTACAACTACGCTACAACAACGCGTAACTAAGCGCGACTAGGACCTAAGTCGTCTCGACGTCGTACCTCGCCTAGACCTCGGAATAGGAGCCGCAACACAC
Strand-209	ACATCCAACACTCTACGCCCTTCAAGAACGAAGGACGCTAAGGTCTACAAGAACAACGCGCTAGATCGACCGCGAGAAGAGAGAGGAGACCTCGACGGAAGAGACTAACTCGAAGTAGGTTCGCCGTAAGTTACGCCAAGAGAGACCTACTAAGAAGAGAAGTCGAAGGCAAGACCGTAAGAGAGGAAGGATCGACTACTACTCGGTAAGAGTTCGCTACTCTAGAAGCGGAATAGGAGCCGCAACACAC
Strand-210	ACATCCAACACTCTACGCCCTTAAGGAAGACTCTCTAACAAGCCGCCTACTCGAGTCTAACGAGAAGAGAGAGACGCGTCTACGCTAGCTCGTCGTTAAGCGCGACCGTCTAACGCGCGTTCGAAGGCTAGTTACAAGCCGGACCTAGTAACAACTAAGCGTAGTTAACCGCTACGACTAACAAGAACGGAAGGACTCAAGAGTTCAAGTAACAAGCTCGGAAGAGAACTGAATAGGAGCCGCAACACAC
Strand-211	ACATCCAACACTCTACGCCCTACGCTAGGAGCCTCGGAGAACTCTCGTACGGTAAGAAGAAGACGAGCCTCGCCGTAGAGACCTAAGTCAAGTAGGAACCTCTCGCGTTCGCGAGCAACGGTAACGAAGGCTACGAAGCTAGTTACGCCGAAGCGGAAGGCGGTACCTACTCGTAAGCGTACTACTCGTAGTAGTTCGGTTCGTAACTCGTCAACGGTCTACGCTACGTCGAATAGGAGCCGCAACACAC
Strand-212	ACATCCAACACTCTACGCCCAGTAGTACCTCGTTACTCGGCTAACGCTAGAACCTACTACCTCTCGAAGGAGAAGGTTAGACTACTACCGTTCTCTACCTCGGTTCGTACGTCGCGAGGCGGAGCTCGTAAGAAGGTCTACTAAGGAACGGAAGTAGTCTCGCCTAGAGACGCAACAAGTAGTCGAGAAGTAAGACGACGTAAGTCGCCTCGAGTCTCGCGAGCGCTAAGGAATAGGAGCCGCAACACAC
Strand-213	ACATCCAACACTCTACGCCCAAGAACGAAGGACGCCTCCTCTCGGAAGGCTACGGCCTACGAGACTAAGCGACGAGAGACGGCTAAGAGTTACTCGCCGGAAGCAAGAAGTTAGAACGACCTACGACGTTCGCCGAACGCTACGCTCGGAAGTTACTAAGTCTAGACGAACGCAAGACTCAAGGAAGTCTCGGACGGTCGTACTAAGACAACGCGAAGTCGAGTTAGTTAGAATAGGAGCCGCAACACAC
Strand-214	ACATCCAACACTCTACGCCCAGGAAGACTCTCTAACTCCTAACGTAAGCTCTCCTCTACTAGAGCCTAAGGTACGCTAGTAACTACGAAGACGTCAAGTAAGCTCGAGACTAGACCGCCGGACCTCTCGGTTCGACGTTAGAACGCTCGACCGGAGACGCCGCCGCGGAACAAGAGTAGAGTCTAAGCCTCGCTCGGAACCTAGAACTCGGAAGGTCGTCGACGCTAAGCGAATAGGAGCCGCAACACAC
Strand-215	ACATCCAACACTCTACGCCCACTAGGAGCCTCGGACTCTACTACGTCTACCTCGCCTACGAAGCGTAGTTACTACGATCGTTCGCGTTAGACGCTCCTCTAACCGCCAAGACTAGTAGCAAGAGACTACAACTCGGAGTAGACGGTTCGACTAGAACGACTACGAAGACCGAACAAGACTAAGGCGGTTCGTAACAAGCTACCGCCGTCTAGAAGACGAACGGAAGTTCGGAATAGGAGCCGCAACACAC
Strand-216	ACATCCAACACTCTACGCCCAGTACCTCGTTACTCCTCGGCGGTAACGCGTAGTTAACGGTAAGACAACAAGGACAACAAGAGTTCTAGAACGCTACGACTAGTCTACTACTCAACCTAGACGTCGCCGGACCTCGGAACAAGAACGCGTTCGAAGGAGAAGACGTCTCGTAGTAACGCTAAGAAGTCGAACGACCTCAACGAACTCGGTACCTCCTCTACAAGTTACGCGAATAGGAGCCGCAACACAC
Strand-217	ACATCCAACACTCTACGCCCAACGAAGGACGCCTCCTCCTCGCCTAGACGTTCTACCTCGGCGGTTAGAACAAGGAACAAGGCGTCGCTAGTCTAACTACTCGCTAGTAACAAGCCTAAGCCTACGCGACCGCGTTAAGTAGGAGCTAACGCAACGAACAAGACAAGTAAGCCGTTAGCTCGGAACCTCAAGCTACTCGAACGTTCGCGACTCTCGGCTCGTAACGATCGGAATAGGAGCCGCAACACAC
Strand-218	ACATCCAACACTCTACGCCCAGGAGCCTCGGACTCCTCTAGACTCGGAGCGTCGGTCTCGAACTCGTCTACGCTCCTCGCGGATCGAGACAACAAGGTCGGAAGAAGAGCAAGTCGTAGAACCTAGAGAGGTTCTAGTAGAGTACGTAGTAGACGTACAAGAACGCGTTCTCGAGAAGAAGGAGAACGACGTTCAAGAGGAAGAAGACGAACGGCTCGAGTTAGTACGCTGAATAGGAGCCGCAACACAC
Strand-219	ACATCCAACACTCTACGCCCACCTCGTTACTCCTCCTCGAAGGTACTAGTACCGGACTAACGTCGACTAAGGAAGCTAGTCTCGAACCTAGACCTCTAGACAACTAAGGCCTCCTACTCGGAAGGAACGAAGGAACCGAACTCCTACTAAGACGCGGCTAGGAAGCTCGGAAGAGTACGAGTTCGTTCGCTCGACCTACGACGAACGGACGCTAGAGCAAGAGAGAACGAGAATAGGAGCCGCAACACAC
Strand-220	ACATCCAACACTCTACGCCCGAAGGACGCCTCCTCCTCGCCAACTAGTTACGATCGTAACGCTAACCTCGAAGCGGCGCTCGAAGTCTAAGAGAGTAAGGTTACGCTAGTAGCTCGACGAGAGAAGGAGAACTCTAAGCGAGAGAGAGGACCTAACTCGAACTACGCTAACGCTAGACTAAGAAGTAGTTCGGCTAACAAGGAAGTAGCCGAAGTAGCTACGCGAGGACCGAATAGGAGCCGCAACACAC
Strand-221	ACATCCAACACTCTACGCCCACTCTCTAACTCCTCCTAACGACCGAACCTCTAAGTCTACGAGAGACTAGTACGTTAAGGAAGACTACTAACGGTTAGAGCTAGTACGTCAAGAGAGAAGACGCTCGGTACGGTACTCAAGAGTAGAGCTAAGCCGTACAAGCGAGTAGTTACCTACTAAGGACTAGCGGACTCGGCCTAAGTACGACGAACGGTCTACTAGAAGAAGCCGAATAGGAGCCGCAACACAC
Strand-222	ACATCCAACACTCTACGCCCAGCCTCGGACTCCTCTACTACGAAGGCAACCTCGTCTACGCTACCGTAGAGTTAGAAGCTAGGTTACTAAGGTAAGAGTACGGCCTCTACAAGACCTACGCTCTCTAACGCAACGCGACTAAGAGACAACCTAGGACTAGGACCGTTCGACCTACTAACGCGAAGACGAACTACAAGTAACTCTCGAAGACGTTAGACGCGAACGAACCTGAATAGGAGCCGCAACACAC
Strand-223	ACATCCAACACTCTACGCCCTCGTTACTCCTCCTCGGCGCCAAGTTCGGTTAGAACTACGCGACGAGTAGTTAGTTAACGTACGTCTAACCTACTAGACTCGGCTAACAACTAACTAGCAACTCGAAGAACAAGAACTAGACGTCGACTCGCGCTACCAAGACCGGTTACGGTAGGAGCTCGACGTTCTAAGACGGAACCTCGAGCTAAGAAGGCTCGAGAGACGGCCTCGAATAGGAGCCGCAACACAC
Strand-224	ACATCCAACACTCTACGCCCAGACGCCTCCTCCTCGTCGAAGTCTCGAAGGAACTACCTACTCGGTCGTAGTTCTCGTTACTCCTCAACTCGACGAGAACCGTCCTACTAAGGACTCAACTACCTCCTACTAACGGTTAGTAGAGCTCGTAAGAACCTCCTCTCGAAGGCGTCGGTAGACAAGTCCTCGCCGCGACGTTACTACGCGGCGAAGAGACCAACTAAGGAAGGGAATAGGAGCCGCAACACAC
Strand-225	ACATCCAACACTCTACGCCCTTCTAACTCCTCCTAACCGCTACTCTCTACCTACTCGGCAAGAGTTCGAGGTAGAAGACTCAAGGATCGAACGGTCTCTAGAGCGCTCAAGGTTACTCGTCGAGAAGGTAACAACTAGAGTTCGCGAGTTACGGCTACGCGTACAAGTACAACCTAACCGCGACCGGTCTACAAGAGACGTCGTAGGAAGACGTCCTCGCCAAGAAGAGTGAATAGGAGCCGCAACACAC
Strand-226	ACATCCAACACTCTACGCCCTTCGGACTCCTCTACGAAGCTCGCGCGTTAAGAGAGTAACAACGCTACTACTAACGCGCTAGTTAAGACTCGTTAACGAACCTAAGGACCGCTACTCAAGCGTAGAGCGGAGAGTAGAGCCTCGGTTACCTCGAAGAGTAGAGTTAGTCGAAGACGAGAACTAGGTACAAGTAAGCTAGTCAAGCCTAAGCTAGAGACGTCGGCCTCGCGGAATAGGAGCCGCAACACAC
Strand-227	ACATCCAACACTCTACGCCCTTACTCCTCCTCGGCGCTACCGTAACTCGCGAACTCTACTAGACCGCCAACAAGAGGAGCTCGAACAACGGCGGAGAGAAGTACAAGAGTCGGACCTCGGAACTAAGAGAAGAGTTCGCCTCGTTACTAACGAGACGCAACTACTAGAACAAGTCGTCGACGTACTAAGAAGGCTCGAGGTTCCTACGAACTCGCAACGGCTAAGCGACTGAATAGGAGCCGCAACACAC
Strand-228	ACATCCAACACTCTACGCCCTAGTTCCTCCTCGTCGGTAGACAAGCCGGCAAGTTCTAACGAAGCCTACGCGGATCGAGCCTCGAAGTCGTCGCTCCTCGGACCGTACAAGCGTACGTCTAACTCGCTAACGCCAAGTAGACGTTAACCAAGTTAGAGTCGGAAGCTCGCGGAAGAACCTACGAACAAGGCTCGTTACTAACCTACTAAGGCGTCGAACTACCTCTAGACGAATAGGAGCCGCAACACAC
Strand-229	ACATCCAACACTCTACGCCCTAACTCCTCCTAACCAACTCGTCGAAGTTCGGAGAGTAGACGAGTACGTAACGCAACTAACTCGGTAGGTACGGACTACTCCTAGACGGAAGGTAGTTCTAGTACTCGACCAAGTTCAAGTCGTTCCTAGAAGAGACCGGAGAGAGCCTCGCCGGCCTACTAACGAAGAACGGTAGACAAGGTCTACAAGAAGAGTCGGAAGACGCTACGGAATAGGAGCCGCAACACAC
Strand-230	ACATCCAACACTCTACGCCCAGACTCCTCTACGAAGACGAACGACTCTCGTACCTACAAGAGAGCAAGTAACTAAGCGCTCGGACGAAGAGGAGCGCGTACTCGACTCTACAAGAACCTCCTAGGTAAGAAGACGGTCGGTAAGACGGTTACCTAGACGCGAACAACTAAGTCTAAGTCAACTAAGAGACTACTCGGACCTACGGCGGACGGAACGGTTAACTAAGTACGGAATAGGAGCCGCAACACAC
Strand-231	ACATCCAACACTCTACGCCCTTCCTCCTCGGCGCTAAGACTACGGAAGCGTAGTTAAGTACTCGACGCGGTCTAAGTTAGGAAGGATCGTACTCGAGGAGTTCGAGAAGTTCGTCGACGAGTCTCTAGTTACTAAGAGAACGACTAGAGTTACTAACTCTAAGAACGTAAGTCGCGTTACTAGCTACTCTAAGTTAACTCTACTCGGAACCTAAGGAAGTCTCGACGACGGAATAGGAGCCGCAACACAC
Strand-232	ACATCCAACACTCTACGCCCTTCCTCCTCGTCGGTAGGACTAGCGCTAGACTACGCAAGAACCTCTCGTTACGCCTACGCTACGAAGTCGGTACCTAGAGAACTCGGAAGAACGGTACTAGCTCCGGCAAGTACAACGCGTTAAGTTAGTTCTACGCTCGGAGGAACGTCGTCTACCTCGAAGAAGAACAAGGCGAAGGTTCGAGGAGGTAGTTCAAGTAGGAACTCTAGGAATAGGAGCCGCAACACAC
Strand-233	ACATCCAACACTCTACGCCCTTCCTCCTAACCAACGCTACCGGAGAAGAAGACGAACTCGTCAACGCTCAACAAGGCTAGACCGGAAGCGGAAGCTAAGGCGCCGCCGCGGAAGACGTCTAGAGTACCTACGTCGCGACTACGAAGACGACGAGGAACCTACTCGCCGTTCAAGCTCGCGAAGGTAGGTCTACTAAGTTCAACGGAAGCCTACCTAAGAGAAGAACGAAGGAATAGGAGCCGCAACACAC
Strand-234	ACATCCAACACTCTACGCCCTTCCTCTACGAAGACGGTACGTAAGCTACGAGTACGAGTAGAACCTCGAACGCCGGCGCGGAAGCTCTCAAGTAGAGAGGTACGAGTAGGTACTAGTCGTAGTACCTACGACTAACCGCCGGAAGGAGGAGAAGCGGTAGTACGAGACTCTAAGCGAGGAAGACCAAGAGCGCTACTCGCGAAGCCGGCAACGAACGAGAACTCAAGAACGAATAGGAGCCGCAACACAC
Strand-235	ACATCCAACACTCTACGCCCTTCCTCGGCGCTAAGAACAAGTCGAGACGCGAAGTCGGAAGTCTCGAACCTAGTACTACTCTAAGAAGGAGGTACGGACTAACTAACGCCGCTACCGGCCTACGATCGTAGACTCGAGACTAGTAGTTAGAGTAGACTAGAAGGACTAAGTACAACGGAGAGTAGAGACAAGGCTAGTCGTCGAGTCGGAACGGAGACGGAACCAAGTACGAATAGGAGCCGCAACACAC
Strand-236	ACATCCAACACTCTACGCCCTTCCTCGTCGGTAGGAACCTACGAAGTTACGAAGAGAAGTTCCTAGACCTCAACCTCGAAGGCCTCTAAGAAGACGGCCTCTACCTAACTCGCGAAGGCAAGACTAAGTTCGAACGCCTAAGCGAAGAGAGACTAGACGCGTAGAGGACGACCTAACCTACCTAGACCGCTACCGCGACTACCGAAGGTTAAGTCGGAACCAACTCGTACGAATAGGAGCCGCAACACAC
Strand-237	ACATCCAACACTCTACGCCCTTCCTAACCAACGCTAAGAACTCGAGTACTCGAGAGAGTAACAACCGAAGTAGTACTACTCGACTACTACAAGGCGTCGGTCGGTAGTAACCTAGGTCGTCGTTCGGCCTCGCGTCGAAGTTACCTCTAACCGGTAAGACTCCTCGGACTCTCGGAGAGAACCTCGGCTCTAGTTACAACTCGACCAACGGAAGACAAGCCGCCGCTACCGAATAGGAGCCGCAACACAC
Strand-238	ACATCCAACACTCTACGCCCTTCTACGAAGACGGTAGGTACTCGTAAGCGTCGAGTACTAACGGTAACCTAACGTACAACGGATCGAACCTACCTACGAGCGCCGCGACCGGACTCGTCGTCGTCTACGGCGAACAAGGATCGGAACCTCTCTAGAGCAAGAAGACCTACGTCGGAGAAGAGTAAGAAGCGAAGTTAGAGGAAGGCGGATCGAGAAGCGCGAAGAGACGCGAATAGGAGCCGCAACACAC
Strand-239	ACATCCAACACTCTACGCCCTTCGGCGCTAAGAACGCCGCTCGAAGACCTACGTACGAAGAACCTAAGTAAGAAGAGTTCGCTAGGTTAACCGCCTAGACGACCGCGTAGTCGAGAGAAGACAAGTCGTACGAAGGAAGTACTAGACGCCTCGGACGCGCTCTAGAAGACGCTCGGTAGACCGGTTAAGACTACCTCCTACCTCCTACGAACCTAGACTCGTTCGGAGAAGAATAGGAGCCGCAACACAC
Strand-240	ACATCCAACACTCTACGCCCTTCGTCGGTAGGAACGAAGCTCGAAGTAGCAACGGCTACGTCGCTCGAGGTAACGCTAGGAGAAGAAGGCGGTCGAGTAACGCTCTCGCGGAAGAAGCTCTAGAGAGCCTCTACTAAGAGTACAACTAGTACGAAGGCTAACGCGGTAACGTCGAAGTCGAAGTCGAACGCGGCTAGAGGAGGAGGAAGTTCTCGACCTAGACTCGGAGTGAATAGGAGCCGCAACACAC
Strand-241	ACATCCAACACTCTACGCCCTTAACCAACGCTAAGACTACTCGACTCCTACGACGCGAAGGTTAGGAACTAGAGAGGTACAAGGAAGGTAGAACGGAACGCCTACGCGTCTCGAGTCTCGCCGAACGAACCGTCGCGAGCGTCTCGTAGTCGTTCTACTACTACGAACTAGAAGCCGCCGTAACGTAGACGAACGGCCTACCTCTCTCGTTAGAGTACGGCTAGAAGTCGGAATAGGAGCCGCAACACAC
Strand-242	ACATCCAACACTCTACGCCCTACGAAGACGGTAGGAGTACTCGAAGATCGTTAGAAGGTTAAGGCGGCTAAGGTAACTACGCTACGTTCCTAGAAGGACCTAACGGTACGAACTCGTAGTACTAGAACAAGTCGTCGAGGAACGCCAACTACGGTACTCTCAAGTCGTAAGAGAGCTCGAGTAGATCGTACTACGCTAGGAACGGTTAACTACTCGCTAGGAGCAAGAAGGAATAGGAGCCGCAACACAC
Strand-243	ACATCCAACACTCTACGCCCAGCGCTAAGAACGCCAACGCTCGAAGTAGTACGACTCCTAAGTCGACTAGCTAAGCCGTTCCTCGCTAACAAGACGCCGTCTAGTAACGAAGGAACGGACAAGAGTTAAGGAGATCGTTCTACGGAAGCGCCTCGAAGACCTAAGGTCGGACTAGCGCGAGTACTCTCGGCTAGAACAACCTCGCCTAAGACGCCTAGTTCGAAGCCGGTGAATAGGAGCCGCAACACAC
Strand-244	ACATCCAACACTCTACGCCCACCAACGCTAAGACTAACGGTACGGAAGGAGAAGAGAGCTCGTACCTACTCTCGTTACGCGCGAGACAAGCCAAGAGTTAGACGTAAGAACTCGTCGGCGCCTAAGCTCGGACCAAGAGTTCGAGAGAAGCTAGTTAGGCGTAGTTAAGAACTCTAAGAGTTAACAACGCTCGACTCAACTCGAAGACCTCGAGGTTAGACAACAACAAGGAATAGGAGCCGCAACACAC
Strand-245	ACATCCAACACTCTACGCCCGAAGACGGTAGGAGTAAGAACTACGCTAGCGGACTCGCGACTAGGTACTAGTAGTAGAACTCGAAGAGCCTCGGCCTCTCGTACGCCTCGTTAGACGCGTAGTTAACGAGAGACTACCTAAGAGAAGAGTTCTAAGACTCGTTCGAACCTCCTCAAGCCGGTAAGTAACGACTCTCGTTCTAAGGACAAGCGAGACTCGCGAAGAGTACGGAATAGGAGCCGCAACACAC
Strand-246	ACATCCAACACTCTACGCCCACTAAGAACGCCAACGTCTAGTAGAAGACCTCGTAACCTAGGTTAAGCGGCTAGTTCTAGTTCGCTAACGGAAGTCGGTACGCGTTCCTCTACGTCAAGTACGGTACTAGTTAACGAGAACGCGTCAAGAGGACCGTCAAGGTCTACCTACTCGTCGGAACTCAACGCCTCGGACTAGAGACCGCTAACGCGTAACGAAGTCTAACCGGCGAATAGGAGCCGCAACACAC
Strand-247	ACATCCAACACTCTACGCCCAGTAGGAACGAAGACGCCTAAGAAGAGAAGTAGAGGAAGTTACTAGACGAAGGTCGGAGGTACGTCAACTAGTCGAGAACCGGTACTAGGAAGTAACTAAGACCTACTACTAACTACGCTCGACCTAGTACTAGAAGAAGTCTCGCTAGGTTCGAAGACGGAAGGTAGTACGCGTTAGAGTTCGCTCGACTAAGGTAAGTCAAGACGTAAGAATAGGAGCCGCAACACAC
Strand-248	ACATCCAACACTCTACGCCCAACGCTAAGACTAACTAACAAGAGAGCGCCGGCTACGGAACGAGGACTCAAGCCTAAGCTACTCCTCTAGACCTAAGTACTAGGAGAAGGTAGTAGTTCCTACTAACTCGCGGACTCTACGCGAGTAGCAAGACCAAGAACGTCGCTACTAGTAACCTAACCAAGAGTCTAGAGTAGTACGAACCTCCTAGTAGCGGCGGTAACCAACAAGAATAGGAGCCGCAACACAC
Strand-249	ACATCCAACACTCTACGCCCAACGGTAGGAGTAAGAGAACGAGGAGTACCGTAGAACAACTACTCAAGTTACAAGAAGGCGCGAACGGCGAACGAGACGGAAGTTACTACAAGAGGAGCGGAACTAACGAAGGCTAGAGTCTCTACCTAGAGTTACGCGCGAGCAAGAACCTCTCGAGGTCGACTCAACGCCTCTACGGAACTAAGTAGTTCGGCTAGACGTTCGGTTAAGAATAGGAGCCGCAACACAC
Strand-250	ACATCCAACACTCTACGCCCAAGAACGCCAACGTCCTACCTACTACGAAGACGTAACGCTACGCGAACGGAACCAAGAGTTACGGTACTAAGAAGGAAGTCGAAGTCGCTAAGAGAACGTCGACGACCTAGAAGACTAACGGAAGGAGACTCTAACTAAGCTCGTTAAGGTTCGCCGGTTAACGAGACGTCAACGGTAACTACAACCTCCTCCTCGGTTCGTACTAACAAGAATAGGAGCCGCAACACAC
Strand-251	ACATCCAACACTCTACGCCCAGGAACGAAGACGCCTAGAGTAGTACGTAACAACAACTCGAAGAGTTAAGAACTCCTAGTAGATCGAAGTAGTAGACCGCTCAAGACCTAAGGTTAACCGGTTACGGTAAGACCGCGTTCTAGAACTAAGCGTACGGACAAGTCGGTACCGGCGCGAGTAGAAGAAGACCTCGCGCTACGTAGTACGGACTAACGAGAAGAGGAAGGTTAGAATAGGAGCCGCAACACAC
Strand-252	ACATCCAACACTCTACGCCCACTAAGACTAACTAACAAGAGAACTAACGCGCCAACGCGACCGTAACCAACTCGGAAGCTCTCGCGACGACTCGAAGTAACGAAGAAGCGAAGACGTACTACCTCGGTAGGAGAACGACTAAGGCTACCGTTCCTAGTAACGGCGTCGCCGCCGCGTCGACTCGAGACTACGGCTAAGCGAGCGAAGTCGAACCGACTAAGTCGGAACGAGAATAGGAGCCGCAACACAC
Strand-253	ACATCCAACACTCTACGCCCAGTAGGAGTAAGAGAACGAGGAACGCCGGTCGGTAGAAGTACTACGTCGTCGAAGACGGCGCTCGGAGGCGGTCGACGGAAGAACCTCGAGACGGCTCCGGCTAGTTCTAAGAGTACTACGAACAACGCGCGACGTACCTCGGCTACCTAGAGAGGTCGAGAACTAGAAGAGACTAGACTAACGGCTCTAGAGAGAGAAGTACGTAGTTCGAATAGGAGCCGCAACACAC
Strand-254	ACATCCAACACTCTACGCCCAACGCCAACGTCCTACCTAGTACCGCCGTTAGACAAGCTCGAAGTAGCGCTAGAGACTAAGAAGGTAAGAACTACTAGAGCGCCGCTAGGAACAAGTAGACCTCGAGGCGGAGCCTAGAACTAGAGTCGACGTAACAAGAGACTCGACTCGGCCTAGAAGAACGAAGCGCTAGGCGGTAAGCTAGTAGAAGAACTCGAAGGAGCTCGTACGAATAGGAGCCGCAACACAC
Strand-255	ACATCCAACACTCTACGCCCAACGAAGACGCCTAGAGCAACGAACAACGAGAACGCTAACGCTAGTTACCTACGACGAAGAAGAGAAGGAGCGGCGAAGCGACCAACGGACTACTCCTCGCGAGTCGGTAAGAGAGCAAGTAGACCGAAGCGGCCGGATCGTAAGAGACCGTTAGGACGACGTTAACGACTCCTAGGTCGTTAAGACGCTACGGTTAGTTCCTACGACCTGAATAGGAGCCGCAACACAC
Strand-256	ACATCCAACACTCTACGCCCAAGACTAACTAACAAGTCAAGACTCTCGCGGAAGCCGGCTCGAGGAACGGCGCTCGGCGGACCGGCGCCAAGTCGTAGAGACCTCTCTAGTAAGGCTACGTCTACGGCGCGTCGTCGTCGTCGTTCCTAAGTACGTAGAGCGCCGAACAACTAAGGTACGGTTAGAGTAGGAGTTCTAGAAGGTAAGAACTACGACAACGCGGTTCTCTAGAATAGGAGCCGCAACACAC
Strand-257	ACATCCAACACTCTACGCCCAGGAGTAAGAGAACGTCCGTCGGTAAGTTCTCGTAGAGAAGAACGTTCGCTCCTCGAACGTTACGAACCGTAGAAGCCTCGTACGCCTAGACCTAGTCGTAGACGAGGAGTACCGCGTAGTTAGAACCTAGCGCGACTACTAGGTAGTCGACCGAAGTCGCTCGACAAGCCGGCCTCGCTCTAAGCCTAAGGTCTAGACGCTCGACGAACGAATAGGAGCCGCAACACAC
Strand-258	ACATCCAACACTCTACGCCCACCAACGTCCTACCTAGTACCAACGAACCTCGGAAGACCTAAGTCGGAACCAAGAGGTAGGAAGACAAGTAAGAGAGGAGCTCGTAGTTCAAGACCGGCGGTCTACTCGGCGCCTACCTCTAAGGACTACAAGGTAACGTCTAACCTAAGACGAGAGACGTCTACTACTAGTTCGTCGGCGAAGACGTTACTACTCGGTAACGACTAAGGGAATAGGAGCCGCAACACAC
Strand-259	ACATCCAACACTCTACGCCCGAAGACGCCTAGAGCAACGAAGACAACGAACGCCTAAGTACGAGCTACAAGTACTAGAGTACCAACGAAGGTCGGCGGTAACAACTCGTCGTCTAACAAGTCGGTTCGTAAGGCCTCTAACTAAGGAGGACCGTAAGGACTCCTCGCCTACGACCTCAAGGCTAGTCGGAACAACGCGCTAAGTCGAGTAACAAGAAGTTCAACGGAAGTGAATAGGAGCCGCAACACAC
Strand-260	ACATCCAACACTCTACGCCCACTAACTAACAAGTCAAGAGTACCGCCGCCGCTCAACTAAGACCTACGTTCTCGTAGACGAGTAAGAGCAAGACCGTACCTAGCAACGTCTCGAGGTAGGAACTAGCTAACGGCGGAGACCTAAGAGAAGGTAAGTAGAGTAAGACTCGGCGGTTAGAGACGACGTAGAGAACCTACGGTTACGGCGAACGCAACCTCCTAGACTACCTAGAATAGGAGCCGCAACACAC
Strand-261	ACATCCAACACTCTACGCCCAGTAAGAGAACGACTCGAGACGAACTAACTAGCAAGTACGGTCTAACTCGGTAGAAGTAGTACAAGACGGAAGACGTCGGCCTCTACGTCTAAGCCGAAGCGAACCTAGAGTAGAACGGAAGACGCCTCTCGACGTACTACTCGTAGACGTCGTTCAAGACTCCTCGACAACGCCTCGCTCGGACTAGTTACGCGAGCTACTCGAGAGACGAATAGGAGCCGCAACACAC
Strand-262	ACATCCAACACTCTACGCCCAACGTCCTACCTAGTACGTAGAAGTCGTTCGGACTCTAGTCGAACGCGAGGACCAAGTTACCTCGCGAACAAGAAGAACTACGACTCGCCGCTACGACTCGACGCGGTTAAGGACGCGCTCTCTACCTCGCCAACTAGTCGTCGACGTAAGACGCGTACGCTAGAGACTAGAGAAGGTAGTTCTAGTCGACGAACGGTTCGTCGAGCGGAGAATAGGAGCCGCAACACAC
Strand-263	ACATCCAACACTCTACGCCCAACGCCTAGAGCAACTAGGAAGTCCTCAAGAGCAAGAGCGGCTAACTCGTCAAGTACGAAGACGCGAACAAGACGAGCGTCAAGAGATCGACGGAAGTCGCCGAACCTCCTCGGAGCGGCGGAGAGGAAGTCGAAGAGTTACTAACTACCGGCGGCGCGACCTCGTCGTCGTAGAGAGAGTTAGTAACTCTCTCGTAACAAGAGAGGTCTGAATAGGAGCCGCAACACAC
Strand-264	ACATCCAACACTCTACGCCCAACTAACAAGTCAAGTAAGCTACTACCGGTCTCTAGAGGTACGCCGGAGAAGTCCTCGAACAACGCTCGACTCGGAGTAGTAGAAGTCGGAAGAGTTCGTCGACTAGGTCGGAAGCGAACAACGGTAACGCCTACTCGAGGACTACCTACAAGTACAACTCGGAACGAACGTACCTAGAGAGCGGTTACGCCGCTAACCTACTAGACTAAGAATAGGAGCCGCAACACAC
Strand-265	ACATCCAACACTCTACGCCCAAGAGAACGACTCGAACGAGTAGTCTCGGAACCGGTTAAGTCGGTTAAGACGCTAACGAAGGTACCGGCGGCTAACCTACTACGAGGTTACGCAAGAGTTAACAAGGCTAAGCGACCGTCGGAAGGTTACGAAGAACCGCGAGCTAGAACGAAGCTCGCGAAGGCGCGACGTACTAAGAGAGGACCTAACTAGACGGTAGGTTAACTCTCGAATAGGAGCCGCAACACAC
Strand-266	ACATCCAACACTCTACGCCCAGGTTACCTAGTACGTAGAAGAACCTAACGAACTACCTCGGCGCTAGCGCCTCGTAGAACCTAAGAGACGTCGGCGTCGGTAGCGTCAACTAGAGCGTCGTCGGCTCTAGGACCGTTACGACTACGACCGGCTAACGACTAAGTACCGGTTACTAAGACGAAGAGTTACAAGCGTAAGGCGAACCTCGGAGGTACGTCGGAGACGCTACGGAATAGGAGCCGCAACACAC
Strand-267	ACATCCAACACTCTACGCCCACCTAGAGCAACTAGGAAGTCAACGCCAAGTAAGAACCTCGCGCTCGCAAGTCGAGTCTAACCTAACAAGGAAGACTCGGCCTAAGGAGTAGGTACGGTCGGAAGAAGTAGTAGAAGTTCGGAGACCTAAGTACTCGCGAAGACGAAGTCTACCTACGCCTAACTCCTCTCCTCGGACTAAGGTACGGCGCGTAAGAAGTCTCGTAAGGTGAATAGGAGCCGCAACACAC
Strand-268	ACATCCAACACTCTACGCCCTAACAAGTCAAGTAAGCTACTAACGCTAGTTCGTCGTACGGCGCTAGACCTACCTAAGGCGGTAAGACGAGGAGGAGCGCGAGCGCGTAAGTCGCCTCGTTAACGACTACTCGGTAGACCGGCGCCGTCGGACCTCAAGCTAGTCTCTACAACTAGTTCGCCAACGCGTCGTACTCGAGACGCTCGTAGTAAGTAGAAGAAGCGGAACGAGAATAGGAGCCGCAACACAC
Strand-269	ACATCCAACACTCTACGCCCAGAACGACTCGAACGAGTACTACCGGTTACCTACGAACCGGTCCTAGGTCGTAAGAAGCTCTCGCTACTCGGTAGTTCGCCGGCGAAGGTACTCGAGAGAGCCTCAAGAGCCTAAGCGAACGAAGGAACGGAAGAGAGACGTCGTTAAGGTTACAAGAGGAACGAACGGAAGGTCGGCGGACCTAAGACGGTAAGAAGCGTACCGCCGAAGAATAGGAGCCGCAACACAC
Strand-270	ACATCCAACACTCTACGCCCTTACCTAGTACGTAGAACGGTCGGACTAACTAGACTCGGACTACCTAAGGCTAAGTCTAACCTCCTAGCGGCGCCGTTAGTACGACTACGAGTAACCTAACTCTCGGTACTACCAAGTTAGAACGCAACGTCAACGCTCTACGAACGTAAGCCAACGGATCGAGGAGTCGGAAGTTCCTCTACCGGACCGAAGTCTAAGAGTACTCGACGGAATAGGAGCCGCAACACAC
Strand-271	ACATCCAACACTCTACGCCCTAGAGCAACTAGGAAGAGTAGAAGAGTACCGCGAGGAACGAACAAGAGTTCGCTCGGTCGAAGGAAGGCTAGTTCAACGCTAGAGAGTACCTACCTAGTCTCTCGAAGTACTAACAAGGACGCGCCAAGACTCGAAGACAACTCGGAAGTAGACGCCTCGAAGGAGAAGCGTTACCTCTAGACGGAGACGTCGCCGCCGCTCGGTAGTAAGAATAGGAGCCGCAACACAC
Strand-272	ACATCCAACACTCTACGCCCTAAGTCAAGTAAGCTCGAACGAGAAGTCTACCTAGGTAAGCTCAAGAACGAACGACGTCGAGCGAACTAACCGTTACCAAGTAAGACGTCGTCTAACTAGAACCTCTAACCTCGAGGCGGTACGGTTAGAGCGCTAAGAGTCGGTAGACGGAAGAACAAGCTCAACTACTCGAACCTCGCAACGGTAAGACGAAGAGCGGATCGAGTAACGAATAGGAGCCGCAACACAC
Strand-273	ACATCCAACACTCTACGCCCACGACTCGAACGAGTACGAACTAAGGAACGTTCGGTTACTACGAAGCGACCTCGAGGAGCGGTCTCCTACCTAACGTCAACTAACGCTAAGCCTCGTTAGACCTACTCCTCTAGAGGTACGTCAACTACAACAACGTCGCCAACGCGAACGTCGCGACCGCGTACGGACAAGGCGGTAAGACCAAGACTAGACCTCAAGACAACCTCTAGGAATAGGAGCCGCAACACAC
Strand-274	ACATCCAACACTCTACGCCCTACGGTACGTAGAACTACAAGACGACGAGGTACGCTAGTCGGTTCAAGACTCTACGAAGCGGTTACGCCTCGTAAGCTCGAACGACGAACAAGAAGAGTAGTAAGTCGAGCTAACTCTAAGTCGCTAGCGGTAGTAAGACTAGTCTCGGTTACCTCCAAGTCTAGTAAGCTAGTACTCGCGGTTAAGCGAGACTAGAAGACCTCCTAACCGAATAGGAGCCGCAACACAC
Strand-275	ACATCCAACACTCTACGCCCAGCAACTAGGAAGAGAGTCTAAGCGGCCTAACGACTCCTAGCCTAAGCGTCCTCGCTCGAACGAACCTAAGGTAGTTCTAGTACAAGAGGTAAGAGAACGCGACGAAGTACAACTAAGGCTAGTTCTAAGCGTCGAGCAACCTAGAAGTCGCGTTCGCGTTAAGAAGAACGTTCTAACTAAGCTAAGACAAGTTCAACGCGAAGACGAAGGAATAGGAGCCGCAACACAC
Strand-276	ACATCCAACACTCTACGCCCAGGAAGTAAGCTCGAGAGAAGAGATCGTAGACTAGTTAACCTCTACTCAACTCGTTACTCCTCGAACGCTAGTAACCTAACGCTACGTTCGCCTAAGGTCTACGCTAAGCTAACGAAGGTAAGTACGCTAGCTAACTAGACTAGAAGAAGAGAACGGAAGAGACGACGACGCAAGGTCTAACTCGCTAGACCGAAGGTAGGTAGTAGAAGGAATAGGAGCCGCAACACAC
Strand-277	ACATCCAACACTCTACGCCCACTCGAACGAGTACGAGGAGGTTACTACGACTAGAGTAACTCGCTCGCAAGTAAGCTCGAGAGTTAAGACTCGCCGCGTACTACGGAAGCTAGAAGAACAAGACGAGAGAGTAGGAAGGCAAGTACGCCGCCTACGGCGCCGTACTAGACCTCAAGACCGTCTACTAGAGCGCGAGGTAGGAACGCGTCGGAAGGAAGAGGAGGAGGTAGGAATAGGAGCCGCAACACAC
Strand-278	ACATCCAACACTCTACGCCCAACTAGGAAGAGAGTAGTAGACGCTAGACGAGTAGCAAGAGGTCGTAACTAAGCTAACTCGGTCTCTAACCTCCTACGAGTAGGAGCCTCTACAACGAACAACTAAGGTAGAGCGGACGCCTCGGAAGACAACGACGCGCCGGCGCTCTCGGCGGTAACGAAGAAGAGACGACGTCGAACCTAGAACGAGAACGAAGGAACGCTAGCGGTGAATAGGAGCCGCAACACAC
Strand-279	ACATCCAACACTCTACGCCCAAGTAAGCTCGAGAGAACCTCGAACTCGTCGCCGGCGCTCTAACGTAAGGCTACTAACTACCTAACAACGGTAGTTACTAGTCGACTACTAGGAGCGCGAACGGTAAGAAGACCTCGAGACTCGCCGTTCAAGCCGTTCCTACTCTCTACAAGTACGAAGGTTAGTCGTAAGGAAGACAAGAGAGACCTAACGGCGCTAGACTACCTAGCGAATAGGAGCCGCAACACAC
Strand-280	ACATCCAACACTCTACGCCCACGTAGAACTACGCTCGACTAAGTAGCGCCGCGTAAGAACTAGAGTTAACCGCCGTAAGACTACTACGCGCTAAGAAGACCGGAAGTTAGAACTCGTCGACTCAAGAGAGCCTCGCTCGACGCTAGTCGAACTACTCGAGAGACGCCGGCCTAAGGTTACCTCTCGCTAGAGACAAGAGTTAAGCGAGTTAGGAACGAAGTTAAGACTAAGAATAGGAGCCGCAACACAC
Strand-281	ACATCCAACACTCTACGCCCTAGGAAGAGAGTAGTAGACGCAACTCGTCGAGAAGCGGCTAGTCGTACGGTAAGACTAACGGTCGGCGGTAGAGGTCGAGAACTCTCGCCGTCTACAAGTTCGAAGAACTCCTACGAAGAAGATCGAGTTAACTCGGACAACCTCGCAACTAGGAAGGCGGACTCGCGAGAGACGGCAAGACTCGAACGTACGAACCTCGAGAGTTAGAGGAATAGGAGCCGCAACACAC
Strand-282	ACATCCAACACTCTACGCCCTAAGCTCGAGAGAACCTCGCGACCGTCTAACGACGCGTCCTACCTCGAAGTCTCCTACTACGCGAACTCGCGTAAGGATCGTTCGAACTACGCAAGGAACGACTCGTCTAACAACTAAGTACCGTCAACGGTAGCGCTAAGAGAAGTACCGGAGAAGCCGGCGGTAGCTAAGAAGCGACCAACCTACTCGGCTAACTAACCGGAAGCTAAGAATAGGAGCCGCAACACAC
Strand-283	ACATCCAACACTCTACGCCCACGAGTACGAGGAAGTTAGACCTCGGCGCCGCCTAGGCCTCGAAGACCGCTACTAGAAGTTAAGACGCCTAGTAGAGAACCAACTAGAAGAGTAGTAGGTAACGCGAACCTAGTTCGTTCTAGTTCTAACTACCTCCTAAGAGGTACGCCAACAAGTCGACTCGGAGTTCGGAAGAAGAAGCCGAAGCGTAAGCGTTCCTAAGTACCTAGGAATAGGAGCCGCAACACAC
Strand-284	ACATCCAACACTCTACGCCCTAGAACTACGCTCGACCTAAGTTACCTCTCGAACTCTACCTACAAGGCTAGAGTCGGTTAAGCGGCGAAGGTTACGCTCTAGAACGCGGACAAGAACGCGGTCGGTAGAGCAACTAAGGTTAGAAGTTCTAGAGCGAACGCAAGAACAAGTCGTACTAACAAGGTAGTACCTAACGACTAACTAGCGCCGGTTAGAGAAGTAGTTCGGAAGAATAGGAGCCGCAACACAC
Strand-285	ACATCCAACACTCTACGCCCGAAGAGAGTAGTAGAAGTCTCGGCGCGTTCGCGTTCGCGTACGGACTCTCGAGCGAAGAAGGAAGCAAGAGACAACCTACCGCCTAACGCGGTACCTCGTTCAACTAAGGCGCTAACCTAGAAGAGGAAGCTCTACGAGAGGAAGCCTACGCTACTAGAAGAGAGACCGCTCGATCGTAGAGCAACTAGAGAACGAGGACTCGAGAAGGAGAATAGGAGCCGCAACACAC
Strand-286	ACATCCAACACTCTACGCCCACTCGAGAGAACCTCAAGTCGAGAACTAGTACGACTAGGCGGAACCTAGAGTAGTAGACGACCGTCTACTAGTTAAGCGCGTTAAGGTCGTTCGCTACTCGAAGTTAGGAAGCTAGAGAGACTAAGTTCGGCTAAGCGAGCTAGAGCTAGTTAACCTAACTAACTCCTACTAGGAGGAACGCTCGATCGAAGTCGTCGTACTAGAGAACCGAATAGGAGCCGCAACACAC
Strand-287	ACATCCAACACTCTACGCCCAGTACGAGGAAGTTAAGGACGTTACAAGGAAGACCTCGATCGTCGAGTAGAACCGCCGGACTCGGAACTAAGAACGGCTCGAGAACTAGTAAGAAGTAACGAAGGACGTACCTAACTAACCTCGCGTCGACCGAAGCTACCGCCTCGGAACGCGTCTAAGAGAACGAAGTCTCGTAAGGACCTACGTACGCTCGTACCGCGTAACCTCGGGAATAGGAGCCGCAACACAC
Strand-288	ACATCCAACACTCTACGCCCAACTACGCTCGACCTACTAAGAGCGCTAGGTAGAGAAGCGGCGGAGACAACGAACTCGGTTAGAGCAAGTTCAAGAGCCTAGAGAACGCCGGACTCGGATCGAGAACGAGACAAGGTTACTCGTAAGCTCGGTCGTCGAAGACCAACTCGAGGACTCAAGACCTCGGAGAGAGCCTAACCGTAACGAGGACCAAGTACGAAGAAGACGCTGAATAGGAGCCGCAACACAC
Strand-289	ACATCCAACACTCTACGCCCAAGAGTAGTAGAAGTAGTTCGAGGTACGCTAACTAAGAGTAACAAGCTCAACTACCTACTCAACAACCTCGGTAGTAACGAAGGCGGAGCGGTTAAGGACTACGCTACTCGACCGGAAGCTACTAGTTAGAGAGTTCGACGAGCGGTAGTCTCGTCGCGAAGAGCTAACAAGCCTACTAGTTCGAACGAGAAGGCTAAGGAGAAGGAACTGAATAGGAGCCGCAACACAC
Strand-290	ACATCCAACACTCTACGCCCTCGAAGAACCTCAAGAACGCGACTCTAGAGAGAAGGTAAGCGTACGCGAGATCGAAGTAAGTCGCCTAGACTAGGAAGTAGACGTAGTAAGAGAGAACGAACAACTACGCGACGAGCAACGAACCTCTAAGTTACTAAGTCTAGAGACGGTAACAAGGAACGTACGCCAACTAGTCGTCGAGTCGGACGTAAGCGTCGAGAAGAAGTCGGGAATAGGAGCCGCAACACAC
Strand-291	ACATCCAACACTCTACGCCCACGAGGAAGTTAAGGAACTACGGTAGGTTAGACGGAGAGAGTAAGTAACCTACTAACTCGTACTAGAGGAAGAGCTAAGGCGCGTCGTAGAGAACTCGGAGGCGGACCGAAGCGAACTAGAGTAGTTACTAAGACAACGTCGCTCAAGGTTCGAGCGGAAGACTCGGACCTAAGGCTCGGTAACGCAACGGACTAGAACCTACCAACGCCGAATAGGAGCCGCAACACAC
Strand-292	ACATCCAACACTCTACGCCCTACGCTCGACCTACTAAGAGCAACCTACGACTACGCTCGAGTCGGTTAGAGAGCGGAAGAACGAGCCTCGCCTCGAGTCTAGACCTAAGGACCGCCAAGAGGAGTTAAGAAGCTCTAAGGACGACCGTAAGTACCAACGGCCTAACGTACTAGTCGTACAACGGTCGGACTCCTAACGCGTTACAAGAGAGAGACGGAGAGAGTCTCTACGAATAGGAGCCGCAACACAC
Strand-293	ACATCCAACACTCTACGCCCAGTAGTAGAAGTAGTTCGTTAACCGCCGCCGCGTCGAAGAAGAGATCGGCTCAACCTACTCAACCTACGAGCGCGTTCTAAGCTACGACTCAAGAGTTCGGAACGAGTTAACGCGCCGTCTAAGCTACCAACGCTACTAGCAAGAGGACCGTAACTAGGTTAAGGAGTACTACTCGGAGTAGCGTCAACGGTAGTAGTACGAGCGGCGGAGAATAGGAGCCGCAACACAC
Strand-294	ACATCCAACACTCTACGCCCAAGAACCTCAAGAACGGAGACCTCGTCTAACAAGACCTCGCGAGGTTACGAGAAGCCGAAGAACTACTAACGTACGCCAAGAGAAGCGGCGGCGGACCTAAGTCGTAGTTAACCAAGTTCTAAGACTACCTACAACCTACCAAGACGAGGTAGACCTAACGAAGCGAAGCTAGTTACAACAAGGAAGGTAACTAACTCTAGAGCGTCAAGGAATAGGAGCCGCAACACAC
Strand-295	ACATCCAACACTCTACGCCCAGGAAGTTAAGGAACCTAGAGTTAACGAAGAACGGCAAGTTCGCCGTTAGCGGTAGTCTCGCGAGTAGTCGGACTAGGTTCCTAACGTACGAACTCGTCTAACTAACCGGACGCGCCGTACGACGCCTCGCCTACTCGTAGACGTACCGGAACGGAAGTACGTCGTAGACCGCCGGCCTCTAGAAGGACGGCCTCAACAAGTTCTACGAAGAATAGGAGCCGCAACACAC
Strand-296	ACATCCAACACTCTACGCCCACTCGACCTACTAAGTACTCGTACGGTAGTAGGACGAGGAAGAGACTAGAGAACGCTCGGCGGAGTTCGAGTAGCCTCGGACCTACGTACCTAAGAGACAACGGTACTACGAGAACCTACGCGACGTACAAGACTCGACAAGAAGGCGGAGAAGGTAACGCTCGCGAAGAGAAGAGTCTCCTCGCTACCGCTCCTCGGTTCTAGTTCTAGGAATAGGAGCCGCAACACAC
Strand-297	ACATCCAACACTCTACGCCCAGTAGAAGTAGTTCGAGTAGAGGTACTAGTACCAAGTAGTAGTCGAACGCTCGAGAGACGAGCGAAGACGGTAGACCTAGGACTAACGGTTCGACCAAGGAACAAGGAAGCGGCTAGACTAGACAACGAAGCGCCGTACTCTCGACCTACGGTCGGAGGAGACAACAACTCGCTCGGCGGCGTTACGGTAGCTAAGGAAGCCGTCTCGCTGAATAGGAGCCGCAACACAC
Strand-298	ACATCCAACACTCTACGCCCAACCTCAAGAACGGAGACTCGACCGCGTAAGCCGTTAGGACGACCGAAGAGAGTTCGTAACAACAACCTACGACGACTCGAAGTCGGTTCTAGAGTTCGTCGAGGAGCGAAGGCGGACCTCGAAGAGAAGGCTACGGTTACGCGAAGAGCTCGACTACTAACGTCGAACGACTCTAAGAAGCGTTCAAGTTAAGGTAACCTCGAACGAGGGAATAGGAGCCGCAACACAC
Strand-299	ACATCCAACACTCTACGCCCAAGTTAAGGAACCTAGACGCGGAAGTCCTAAGTTCGTACGGACAAGGCCTAAGACGCTAGAAGTTAACGAAGTTCCTCGGCTAGAGCGGTTACGGTAGAGACTACGGTCTAACTCTCGCCTAACGCTAGTAGACTCGGTACGCGACGACTCGCGTCTACTACAAGAGGTAGAGGAACTAACTCGAAGGTTCGAACGCCGGCAACAACGGTGAATAGGAGCCGCAACACAC
Strand-300	ACATCCAACACTCTACGCCCTCGTACGCTAAGTACAACTAGACTCAACGATCGAGGTTCGGCGGAACTCCTAGTTAAGACGCCGTAACCGTTCGGAACTACTACGCGAGTTAAGCTACCGGTTAAGGCGAACAACGAAGCAAGTCGACGAAGTTAAGGCGGAAGAACTAAGTCAAGACGAGCCTCGTCGCCGTCCTAAGGAGATCGAGGAGACCTCGGTCGAGGACTCGAGAATAGGAGCCGCAACACAC
Strand-301	ACATCCAACACTCTACGCCCAGAAGTAGTTCGAGTAAGGAAGGTTCGTAAGTCTCGTTCTAGTTCGGTCGGAGGACCGGTAACGGAACCAAGTTAACGTTAAGTTAGACGAAGGAACGACTAACGTTCGGCCTAACTACTCGAAGCCTCGGAAGTAAGTACGCTCGCTACGCTCGACCTCTAACCTAAGGCTCGTTCGCGTAACTCGGCGGCTAACCTCGCAAGAGTACCGAATAGGAGCCGCAACACAC
Strand-302	ACATCCAACACTCTACGCCCTTCAAGAACGGAGACTCGACCAACTCGTAAGTCTACGCTCTCTACGTCCTAAGGTACCTCGCCTAACAAGCTAGCGGTTAGAAGAACAACGCCTAAGAGAGGTAACGCTAACTAGAACTCAAGTTAACGAGTACTAAGACCTCGTCGTTAACGACGACGTAGACTAGAACCGCCGCCGAAGCTACCGTCGTCGGAGAGGAAGGACTCGGCGAATAGGAGCCGCAACACAC
Strand-303	ACATCCAACACTCTACGCCCTTAAGGAACCTAGACGCGACGACCTACGTCGGAAGCGCGTACCTCTAACCTCGCTAGTTAAGCGGTAGAAGTAACAAGAGACAACTCCTAAGTCTCTAAGGAACTACCTACGCCAAGTTAAGCGCGACGTAACGCAACAACAAGTCGAAGTACGCTAGGACTCAAGCGACTCCTCTAGCCGAAGCGTACGGCAACGTCAACGCGTTCTAAGAATAGGAGCCGCAACACAC
Strand-304	ACATCCAACACTCTACGCCCTACGCTAAGTACAACTACAACCTCGCCGAAGGTAAGTTAAGTACCGGCGGTACTCGATCGAGTTACTAGTCGTTCCTAACCGAACGACCTAAGAAGAAGACCTAGACTACTAGGTAACTCGCCGCTACCAAGACTCTAAGGTAGTCGAGCGAAGCGAGACTAACGACGTTCAAGACTCAAGAGTAAGAGTTACAAGTCGGATCGAGATCGGAATAGGAGCCGCAACACAC
Strand-305	ACATCCAACACTCTACGCCCAGTAGTTCGAGTAAGAGTTAGTAACTACAACGAAGACTAAGCAACGCGACCAACGGATCGAGAGAAGGTAGGACTCGACCTCGGAGGACCGCGAACTAGTACGAACTCGAAGGAACTAGCGCGAGGAACTCGTAACTAGAGACGTTCAACAAGGAACCTAGAAGCGCTAACAAGAACGGAAGTAGCGGCCTAACCGTCGTCGGTTAGAAGGAATAGGAGCCGCAACACAC
Strand-306	ACATCCAACACTCTACGCCCAAGAACGGAGACTCGAAGAGATCGTTAACCGGACCTAGCGGTAGGCGGTAAGAGACGAAGTAGAACTAGGAAGCGTACCTCTAACGAAGACGCGCTACCTCGACGAGAGAAGTCTACGTCGTCGGTAACCTCAAGAACGCGGAAGAGAAGTTCGAAGCCGGAGACGGAAGACCTACCAACCTAAGGTTCGGTTAGGAACTAACGGAGTTCGAATAGGAGCCGCAACACAC
Strand-307	ACATCCAACACTCTACGCCCAGGAACCTAGACGCGAGGTTAACGAGAAGTCTACCTAGGTTAACCAACCTCTACCTAAGAACGAACAAGACTCCTCGCCTCGCGAGGAACCGGTAAGACTAACTAGAACTACCTACGAGCCTACAAGCTAGACCTCTAAGGAACGCCTAAGAACTCGGTTCGTTCTAGTTAACCGGAGAACTAAGCGGAGCCTAGGAAGCGTACGCGAGTGAATAGGAGCCGCAACACAC
Strand-308	ACATCCAACACTCTACGCCCACTAAGTACAACTACGCCTACTACTAGAGCCTCGAAGCGTTCGCCGGCGCTCTCAACAACAAGAGAGAGAGGTAAGAAGACCTACTAACGTAAGGTAGGAGAGACGAAGGACAAGCTAGCAACCTAAGGAACGCGAACGGTTACCTCGGTAGACCTAACGAAGACAACGTCTACTAGTAACCTAGAACCGTCGTCAACGGCAAGTAACGCGAATAGGAGCCGCAACACAC
Strand-309	ACATCCAACACTCTACGCCCAGTTCGAGTAAGAGTTAAGGCGGTTCGTTCCTCGGCTACTCGAGAGAGAGCGCCGCGACGTAAGACGCCGCGAACAACGGAACTACCAAGACCGCCAAGTAGTTAACGTTCTCGTAGAAGAGGTTCAACAACGTCGGAAGAACTCTCAAGGAAGCCGGCCTCGCTCTCGTCGGCTCGAAGAGAACCGAAGGTACTAGGCGGTAGAACTAAGAATAGGAGCCGCAACACAC
Strand-310	ACATCCAACACTCTACGCCCAACGGAGACTCGAAGAGACTCGCCAAGTAGAGCGGCTACGAACAACTCCTAACCGTCGCGTAGTAAGAGAACGGACTCGAAGTCGGAAGAGAGAACGTCGTCGGTCTAACGAACAAGTTAGAACAAGCGACTAGCTCGAGCGAAGGAACCTCGAAGTAGTTAACGTAGACTAGTACTACTCAAGGAACCGCCGGCGGCTACTAGTTCTACGAATAGGAGCCGCAACACAC
Strand-311	ACATCCAACACTCTACGCCCAACCTAGACGCGAGGTTCCTAGAACGCGCGTTCCTAAGACTACTCGGCCTAGACGCCGAAGAAGTCCTAGAAGCGAGGAGTTAAGGCGTCAAGACCAACGCCGGCGCGTAAGGCTCTCCTCGAAGTCGGTACAAGTTACTAACTAGACTAGAGACCGTTCTCGGCTAACAACAACGAGACGCTACCGTTAGTAGAACGAGGAAGTTCGGTGAATAGGAGCCGCAACACAC
Strand-312	ACATCCAACACTCTACGCCCTCGAGTAAGAGTTAACTCGAAGGTACCAAGTACGGTTAAGGTAGTACCTACGTCCTCGTCGAAGGAACGAGTCTCCTAACGAGCTAACTCCTAACTCCTACGTTAAGGTCGACTACTAGACCTAGCCTACGACTACGCGAACAAGAGAACTACGCCTAGACGTAAGAAGCCGCCAAGAGTTAGAGGACTCGGTTCTAACCTCCTCCTAACGAATAGGAGCCGCAACACAC
Strand-313	ACATCCAACACTCTACGCCCAGAGACTCGAAGAGACTCGCCAACGCGTTAACCAACGGTCTCGCCGGCAAGTTAAGGTTACGACGCTAAGAGAAGACTAAGACCTAGAGAACTACCGCTACGACCGTAACCGCTCAAGCCGCGAACCTCTAAGCCGGATCGTTACTCGCTCGCAAGAGTCTCCTCTACGGTACGTCGAGAAGCGAACTAGAGAGCGAACGTACCGTAGACGAATAGGAGCCGCAACACAC
Strand-314	ACATCCAACACTCTACGCCCTTAGACGCGAGGTTCCTAGAAGACGGCGGTAGAAGACCTAAGTCGTAACCTAGACAAGAACGATCGTAGTCGTAGTTACTCGTCGGACTCGCGAACAACGCTACTAAGTTCTAACCTCCTAACTACTAGGAACGAAGCGGTTAGAGTACCTAAGAGTTACCTCTCGCCGCTAGGAGGTAGACGACCTCGTACTACCTCGCCAAGTTCGTCGAATAGGAGCCGCAACACAC
Strand-315	ACATCCAACACTCTACGCCCTACAACTACGCCGTACGCGGTACCGTTACTCTCAAGAGTAAGAACAAGGAAGACGCTAGTAACGCTAAGTACTAACTAAGAACGTCGTTCGGTACGAAGTAGTAAGAGAGTACGAGAAGTACGACTACGACTACGAGGCGGACGAGTACCGCGAGAACCAACGGTAGCGGACAAGGAGAAGGACTAAGAAGCGCTAACGCTCCTCCTCTAGAATAGGAGCCGCAACACAC
Strand-316	ACATCCAACACTCTACGCCCAGTAAGAGTTAACTCTAACCTCTCGCGAGAACCGTTAGCCTAGAGAGAAGACTAAGCGGTCTAGACGGTAGCGCTCAAGGACTCGAACGACGCGCCTCGTTCGGTTAACTAAGACCTAGTTACGGTAGAAGTCGGTTCTAGAGAAGAAGTACTACCGCCGTCGAACTAGAGAGGAACGCGTCGTTAACGTAACTAAGTACCGCCTCTCGCGAATAGGAGCCGCAACACAC
Strand-317	ACATCCAACACTCTACGCCCAACTCGAAGAGACTCGGAACCTAAGAGTTCGAACTCGGCGAAGCCAAGGAACGCAACGCCGGAAGTCGGAGTTACGTCTCGAGACGCGTCGCGTACGCGTACTCGACTCTCGGCTCGAGACTAACTAACTAAGAGACGACGACGTCGAAGTTCGTCTAAGAAGCGACGAGGACCTACTAGAGGTAGTTAACCAACTAAGCGTTCGAAGTCGAATAGGAGCCGCAACACAC
Strand-318	ACATCCAACACTCTACGCCCAACGCGAGGTTCCTACTACAAGCGGAACTCGTCTCGACGAGAAGCGGAAGCCTAAGTTAAGGAAGAAGCGCGAACGGTAGTAACGGCGCGACTCAACAAGAAGAGAACGGTAAGGAACGGAGTAGTACTAACCTCGGTACCGTAACCAACTAAGTCAACGCGAGTCGGCGGAGACCTCTACTCGGCGTCGCTAACGCCAACAAGAGCTACGAATAGGAGCCGCAACACAC
Strand-319	ACATCCAACACTCTACGCCCAAGAGTTAACTCTAAGAACGCGGTTACTACTAAGGTCGGTTCCTAAGGACCTAAGCCGAAGACCTACAACTCGCGGAACGCGAAGGACCTAGTACGACCAAGAACTAAGGAGAAGAACCTAGGTAGAGTTAGAACTACCTCTCGTAACTAACTAGGTAACAAGAAGTTAGGACGTAAGGCGAAGCTCGAACTCGAAGTAGGTCGAGGAGTGAATAGGAGCCGCAACACAC
Strand-320	ACATCCAACACTCTACGCCCTCGAAGAGACTCGGAACCTAAGACGCTAGCTCGTAACTCCTAACTCGCTAGAGCAACCTAAGCCTCGTCTCGTCGTCGAAGTCGTACAAGTTAAGGCGGTACAAGTAACTAAGCGGTTAGTACTACGCGACGTACAAGAACGTCGCCGAAGGTAGTTAGTCGACTAGCTACGGTTCGACGAGGAAGAGCGCTAGCTACGTCGGAAGGAACGAATAGGAGCCGCAACACAC
Strand-321	ACATCCAACACTCTACGCCCACGAGGTTCCTACTACAAGCGAACTCGACTCCTACCGAACGCCTACAAGCTCAAGACTAGAGCTCGACTCAAGGAGAAGTCGGTAGTTAAGCTCGAGAAGCGTTCGGAGAAGGCGCCGCTAACTAGACTAAGACTCGAACTAGCGGCTAAGAGTAACAAGGAGAGTTCGGTAAGTTACCTAGTACTACTAACGCTAAGTTAACTACGGAAGAATAGGAGCCGCAACACAC
Strand-322	ACATCCAACACTCTACGCCCTACGCCGTACGCTAGACGTACAACTAGAACTCGAGACGCTACTAAGCGACCGTCTAGTTACTAACCGGAACTCGCGAAGAGAGTAGCGGTCGGTACTAGGAACTAAGCGCTAGTAAGAACTACTCGACTAGTAGTCTAAGGAGCGCTAACTCGGAAGACGGCCTAACTACTCCTCGGTACAAGGAAGAGACCTACCTCGTCAACGGCGGTGAATAGGAGCCGCAACACAC
Strand-323	ACATCCAACACTCTACGCCCAGTTAACTCTAAGAACGCGCTACCGCTACCGGCGTCCTCGCCTAAGTCGCTAAGAGACTCCTAAGGAGCGGAACCAAGTCGACTCAAGCGTACTACGGATCGTTCTCGAGGCGGACGACTCCTCAAGTCGGTCGGAGGTCGAGTTCGAACTCTAGTCGGAGACAAGACCTCGCTCTAAGTAACTACGTCGCCTAGTAAGCTCCTACTACGGAATAGGAGCCGCAACACAC
Strand-324	ACATCCAACACTCTACGCCCAAGAGACTCGGAACCGAAGCTCTCGGAACGACTAGGTAGTTCTAACAAGAGAACTCGAGAGAGTCGTAGTTAGAACGCGAACCTAGTAGTAAGGAACTCAAGAACGGTAGACCTCCTCTAAGTACCGTCGCTAGTTACGGCGGCGCGTAGCTAGAAGCCGTAACCGCTCTCGCGGAAGAGTCGACTAGAGAAGTAGAAGTCGGAACGTAAGAATAGGAGCCGCAACACAC
Strand-325	ACATCCAACACTCTACGCCCAGGTTCCTACTACAAGCTAGCCTAAGGCGGAGCTCGAGTAGGTAAGGAACTCTCGGTCGGTCGACTAAGAGTAGGTTCGGAGACGGTCGGACCGCGTTAACCTCGTCGAGGCGGAGAGAGTTACGCGTCTAGTAACTCGCCTCGTAGGAACTCTAGGAAGACTCGTAAGGTTAGTTAAGGAAGACGAGACAAGCGTTAGTCAAGACCTAGGAATAGGAGCCGCAACACAC
Strand-326	ACATCCAACACTCTACGCCCACCGTACGCTAGACGAGCTCGTACAACTACGCTACCAAGAACGGCGCGTTACCTCTCCTCCTAAGGACGACTACTCGGAGCAACCTCCTCGGTACGTAAGCTACTCTAACCTAACTCCTCTACGCTCGGTAGTTAGAGTTACCTCAAGACGGTAGAACTCGGAAGAACGGAACGTCGTAAGAAGACTCGACGTAACTCTAAGGTCGGACCGAATAGGAGCCGCAACACAC
Strand-327	ACATCCAACACTCTACGCCCTAACTCTAAGAACGCGTCGGAAGTTAGACCAACCTACAAGGAACGACGGAAGTCAAGTACGGCGGCGAACTAACTAACGGTACTCGAAGGAACGGAAGGACCTAAGAAGTCTCGTCGTTCGCTCGAAGAGAAGTCGGACTAGAGAGCGGTCTCTAGTCGAACGCCGCCTACTAACTCTAGTACTACAAGTAACCTAAGTACGAAGCTCAAGAATAGGAGCCGCAACACAC
Strand-328	ACATCCAACACTCTACGCCCTTCCTACTACAAGCTAGTACGGAAGCCGGCGCGTCGAGTTCGAACGAACGCTAGTCGACTCGGTACGCTCTAAGTACGTAAGGAGAAGGCGCCAACAACTACGGAAGTAACTAAGTCTACTAAGTCCTAGAACTCGGTCTAAGAACTAACGAACAACTAAGTCTCGCCAACGAAGACTAGACGGAAGGAAGCGCGACTAGTAGTACCTAGGAATAGGAGCCGCAACACAC
Strand-329	ACATCCAACACTCTACGCCCTTCTAAGAACGCGTCAACCTAAGACGCTAGAAGTAAGAGGAAGGTAACGGCGCTAGCCTAACGAGTCGGAGCTCGAACGAAGAACCTACCTACGCTCCTAACGAACGGTACTCGTTCTAGAGTTACGCGTACTAAGCTAGGACGACGACGAACGAACAAGCGAGCTCGGACCTCTCGTACGAACTACTCCTAACTACCTAACGAGCGAGAGAATAGGAGCCGCAACACAC
Strand-330	ACATCCAACACTCTACGCCCTTCGGAACCGAAGCTAAGAACTAAGACGGTAAGACCGGTTACAACTAAGTCTAGGAACAAGGTCTCTCGACCTACCTCAAGTAGAGTAGAAGAGAAGGACGCGCTCTCGTCTAGAGCAAGAGCAAGTTAGAACAAGAGAGGTTCGCGAGGTTCCTCCTACAAGCTACTCGGTTCCTCGAACAAGGAAGCGTCGGCGGCGGTACCGCCTAAGAATAGGAGCCGCAACACAC
Strand-331	ACATCCAACACTCTACGCCCTTACTACAAGCTAGTAGGTAGTCGGAAGTCGTCGCCGCGAGACAACAAGCTACCGTTCGGCGGACTCTCCTCAACTACGAACTAAGTCTCGGTTCGACCGCCGCGAGGAGCTAACCTAGGCGGTAACAACCTAGAAGGAGTTCGACTAGTAGACAAGACGCTCGATCGAAGAGGTAAGGTTAACAAGGACTCTAGTCGTTAAGGTAGAGCGAATAGGAGCCGCAACACAC
Strand-332	ACATCCAACACTCTACGCCCTAGTAGACGAGCAACGCCGCGTCGTCGTCGAGGAGACTAAGCAACTAAGTCGTCGCTCCTAGACTCGCTCCTCCTACTAGGAGCGCCGCGTAAGCGAACAAGTACGCTAACTAGTCGACGAGCAAGTAGTCGAGCGTCGCCGTAGAGTAAGCGTAAGGACCTAGTCTCTCGAAGTCGAGTTAGTTCCTCAAGGAAGGCGGAACTAGACCTGAATAGGAGCCGCAACACAC
Strand-333	ACATCCAACACTCTACGCCCTAAGAACGCGTCAACGAAGACTCGACTAACGCCTCGTCGAGTCGGACGAGGCGGTTAAGAAGGACCGCCTACAACAACAAGTAGAACGCTCGGAGCGCTCTAGACGGTAACTAACTCTAGTTCGGTACGTAGGAACGAAGACTACGAGAGTCGACTACGAACGGTTAGCTCGGTCTAACGAGCGGCAACTACGCGAGTCTCGTCCTAAGCGAATAGGAGCCGCAACACAC
Strand-334	ACATCCAACACTCTACGCCCAGAACCGAAGCTAAGACTCCTCGACTAAGTTACGCCTACCTAGACGCGAACTAGGAACGCCTCGTCGTCTAAGCTACCGCTCAAGAGTTAACGAGTAGTCTAGACTAAGCTCGATCGTCGTAAGTCAACTAACGCGGCAAGAGCGCGTAAGGAACCGAAGGTTAACGAACCGAAGAGTACAACGGCGCTACTCCTACTAGAAGTTAGTACGAATAGGAGCCGCAACACAC
Strand-335	ACATCCAACACTCTACGCCCTTACAAGCTAGTAGGAGCGGTACGTTCTACGCCGGCGCCGCTACCAAGAGAGAGACGAAGGAAGCTCTAAGTTAGAGGTTAAGCTACTAGACTACCGCTAGGAGCGAACTAAGCGAAGAAGGTAGGCGGTAAGCGTACGCTAGTAACAACGCGAGCGAAGCCAAGTAGGAAGCCGTCCTAGAAGAGTAAGAAGACGGCAACTACGGCAAGGAATAGGAGCCGCAACACAC
Strand-336	ACATCCAACACTCTACGCCCTAGACGAGCAACGCCTCGTACGGCGCGAGCTCGAAGAACTAGAACGTCGCGTCGACCTAGAGTAGACGCCTCGCTCGGAAGACGAGCTAAGCCTAGAAGAACGCGTAGTAACTCGCTCGAGGACGCAAGACGACCGCTAACCTCTAAGGCAAGAGCTAGTAAGTAAGTTCGTTCTAAGCTAACGCTCGAACGAAGACCGAACCTACTACCGAATAGGAGCCGCAACACAC
Strand-337	ACATCCAACACTCTACGCCCACCGAAGCTAAGACTCTAACGTAAGAGAACGAACTAAGTAGCTAGTAAGCTCAACGAAGCGTCGGACAAGACGAACAAGACCTACCTCGACCTCCTAGTAACGCGACGTAAGCTCGACCTCTCGGAGAGTTACGAAGAGACGGAACCGCTAGCGTCAAGTTAACTAGTCGGTTAGACAAGTCGTTAGAAGACGTCAACGGATCGTAGAGTGAATAGGAGCCGCAACACAC
Strand-338	ACATCCAACACTCTACGCCCTAAGCTAGTAGGAGCTACTAGACGAGAAGAAGGTAAGGTTCGTTCTCGAACGAAGAGTTACGCAACTAGAAGTTCAACTAAGGAAGAAGTTCGACTACGAACGGCGGCGGCTCGTTAGACGCGTAAGACGCGTACCTCCTCCTACGAAGGTCGACGAGTAGCGCGAGGTTCCTCGCTCTAACCGAACTCTAACCTCGCGAAGACAACGAAGAATAGGAGCCGCAACACAC
Strand-339	ACATCCAACACTCTACGCCCTAGAGGAACGAAGGAAGGTAGAGGACCGGTACGAGGAGCAACGGCGGACCTCCTCGCGGAACCAACGGCTACTAGTTACTACTAACGTACGAAGAAGAACAAGCCGGCAAGACGTAACGCAAGAGATCGAGCCTAAGGTTCGAAGAGGAACTCAACGCCAACCTCGCTAAGTACGCGTAGTAGTCGAGGTAGTAGTAGGAACAACAACCTGAATAGGAGCCGCAACACAC
Strand-340	ACATCCAACACTCTACGCCCGAAGCTAAGACTCTAACCGCGAAGTAGAGACTCGCGTAACCTCGGTTAACTCGAACGTTCTACGTCGTCGGTAGGCGGTACGCGTTACGAACTCGGAAGACCGTAACCAAGTCGTACTAGACCGTACCTCGAACGTAGACGACTCCTACTAGCTAGAGTACGACTACTCGGTCGTAAGGTTAGAAGAACGGCGGAAGCAACTACAACGTCGAATAGGAGCCGCAACACAC
Strand-341	ACATCCAACACTCTACGCCCACTAGTAGGAGCTACGAAGACGGAACGGAAGACGAAGAACTAACGAACCTCGTCCTACTACGCTCGAGGACCGCTCCTAGCAAGTACGAAGCTAACGGCTACGGCGAAGACTAGAACGCGACCGCGAGTAGTTAGACTAACTCGTTAAGACCTCAAGACAACCTCAACGCCTAGGAAGGTAGAACGTAACGACCTACGTTAAGGAGATCGGAATAGGAGCCGCAACACAC
Strand-342	ACATCCAACACTCTACGCCCAGCAACGCCTCGAGCGCTAACCTAACCAACGCGACCTAGGAACAAGGCTAACGCGGAACGTAACGCTCGTACTAAGACGGTTCGAGCTACGCTAACGTTCGACTAAGTCGGAAGACTACCGCTCTAGAGTAAGGTAGCGCCTAGTAAGCTACCGTAACCGTCTAACGAAGCGCGAGGTCGTAGGAACTACAACCTCTCTAGAGGACCGGAGAATAGGAGCCGCAACACAC
Strand-343	ACATCCAACACTCTACGCCCAGGAACGAAGGAAGGAGTTAGAGCTCGAGAACCGTCGGTAGGAGCTACGTCAACAACTACGGCTACGCGACGTAGTTAACGAGCGCTCGGAGCGAACAAGGTTAAGGCGGCTCGTTCAACCTACAACGCGGTAGGTTAACCGTAACCGTTAGAACGAAGAACTACTACGAAGAACGCGCCTAAGAGTTCGGTCTACGACTCCTCGCTAGGGAATAGGAGCCGCAACACAC
Strand-344	ACATCCAACACTCTACGCCCACTAAGACTCTAACCAAGTAAGTCAACAAGTACAACGAAGGCAACAACAACGAACTAACTCGCGGTTAAGGCTAGACTCTAGAAGGACTCGGAACCAAGAGACTAACCTCGACTACTAAGGCTAGGTTAGAGAAGAAGTACCTAAGTACGACTAACCTAAGTAGTAGCGAACTAACGAGACAAGCTACGAGACCTAGTACCGTACTACTAGAATAGGAGCCGCAACACAC
Strand-345	ACATCCAACACTCTACGCCCAACGCCTCGAGCGCTACGAACTAGTCGAACGCCTAACCTACTAACAACTAACGCTAGACTCCTAGACTCGCTAACTACTAAGAGAGCGAAGACGGTTACGGCGCGTTCTAAGGCGGCGCCGTCAACGGCGCTCCTCTCGAAGCGTTCGAAGAGTCGAGCGTAAGTCTCGTCCGTAGCTACTCCTAGACGAACTAAGGAGAAGAAGGTCGGGAATAGGAGCCGCAACACAC
Strand-346	ACATCCAACACTCTACGCCCAACGAAGGAAGGAGTTACAAGGAACCTAGAGAGTAACGCTAGAAGAACCTAAGTAGGAGAACCAACGCTAGTTAGTAGTAACTACTCGTCGGACTCTAAGGCGGTAGCGGCTCGTAAGGCGGACCTACGTTCGCCGTTCTAAGGACGAAGACCTACGGTAGTAGCGTCGCGTTAACGAGCTAGAACAACTCGTAACTCGAAGCCGGCGAAGAATAGGAGCCGCAACACAC
Strand-347	ACATCCAACACTCTACGCCCAAGACTCTAACCAAGAGTTCGACTAGAACTACCTAGTTCGCTCGGTCGTAAGCTACGTAGTTAAGTTAGAACTAACTAGAAGAACAAGAGAAGAGGAGCAAGAAGGAACGAAGTAGAGACGGCGAAGAGACCTAGTTAGACCTAAGTCGGAGGAGTTACGGTAGCGCCTCGAGAGAAGCCTAACGAAGGTAAGCTAACGGACTCGAACGAGAATAGGAGCCGCAACACAC
Strand-348	ACATCCAACACTCTACGCCCAGGAGCTACGAACGAGACGCGAGTAGGAACGGTAACGCTCGAGAAGGCAAGAAGAGAGAACTCTCGTACGCGAAGTCGAAGTAAGCGAGCCTCCTACGAAGAACGTACGCCGCGTTAGAAGACGCTACCTACTAAGCTAGGACGACGTAACGCGCTAAGTAAGCCAACTCGACCTCGAACGGAGAAGGTACCGGACCTCGCGGTTAAGGAGAATAGGAGCCGCAACACAC
Strand-349	ACATCCAACACTCTACGCCCACCTCGAGCGCTACGAACTAGAACCTACAAGGCGAAGCGAGTCTCCTACGCTAGGAAGGTCTCTAGTACTAGAAGTTAACTCTAACCTACGCCGCTAGGTTCGCCGCCGCGTTAAGACGCGGTACTCCTCTCGGCAACAACTACAAGTACGCCTCCGAAGGCTAGTAGTTAGAAGGAGAGGAACTCGAAGAGTTCGCCTCGTTCGCCAACGAATAGGAGCCGCAACACAC
Strand-350	ACATCCAACACTCTACGCCCGAAGGAAGGAGTTACAAGGAAGACGGTAACGAAGCTCTACTCGTCCTAACGTAAGGACTAAGCGAACGCGGAGACAAGACCGGTTAGACGAGTACGAGCGCCGCCGGCGTCGCTCTCGGTACTACCGAAGAACGACAACAACGCCTCTAGACCTAGAGCTAAGGTTCGACTACCGGACAACGCCGTACGAAGAGCTAGAACGGAAGTTAAGAATAGGAGCCGCAACACAC
Strand-351	ACATCCAACACTCTACGCCCACTCTAACCAAGAGTTCGAGTACCGCTCGGTCGACGACGACCTCGTAACGACTCGGACGCAACTAAGCCTAAGACGTCGCCTACAAGTAGACCGCTAGATCGGAAGAAGCGTTACGCGGTAAGAGAGAACTCTAGACGTAACGATCGAGCGGAACCTACTAACTCAAGTTCAAGAGTCGGCGGTACAACCTAGAACGCGGTTCGAACTAGGAATAGGAGCCGCAACACAC
Strand-352	ACATCCAACACTCTACGCCCAGCTACGAACGAGACGGAGACGAACGAGAAGGTCTCGTCGGTCTACGAAGCGGTTCGAGTAACCTCTACAAGACGTAGAACCTAGACGGCTAACCTCGGAGGTTCTACCTCCTACTACGAGAGACGTTCGCGTAGTACGCCTCGACCGGCTAACAAGGCTAAGTCTACCGGTTCGGAACCTCGTTCGCTAGTAGCCTACTCTCCTCCGAAGAATAGGAGCCGCAACACAC
Strand-353	ACATCCAACACTCTACGCCCTCGAGCGCTACGAACCTACGCAAGAGAAGCGTCGTCTCGACTAGCGGCAAGAAGAGCCTCTCGAGCGGAGACTAAGTCGGAAGGAACAACGGTCGGCGGTCGAAGACCTACTAGTAGGAACCTCAAGCGTTCGAAGAAGAAGCTCAACGCTAGTTACGAGAGAGTTAGAGCTAGAAGTCGAGAACTCGGCGGACCGTAAGGAGTAGGAGTGAATAGGAGCCGCAACACAC
Strand-354	ACATCCAACACTCTACGCCCAGAAGGAGTTACAAGTAGGAAGTCGTCTAAGCGGAAGAAGTCTCTCGGAACGCCGTTCCTAACGGAAGAGGTCTCTAACTAGAGACCGAAGCGAACAACTACGTCTACCTCTACGCTAGTAGTACTACCAAGACGAGCGCGACGACTCAAGGCCTAGAGTAAGCGAGTAGTAACTAGAACGGTAAGAGAACTCTACCTAGGTTCTAAGACGAATAGGAGCCGCAACACAC
Strand-355	ACATCCAACACTCTACGCCCTTAACCAAGAGTTCGTAAGCTACTCGGACGAGGTTACGCTAGAGTACGTACAAGTTAAGCCTCAACCTACCTAGGACGTAAGCTCTCGTCTAGAACGCGTTCGCGACTAGCGGATCGTACGTCTACGGTAGGAAGAGTCTCGCTCTCGCGAGTTACTACGGCGGCCTACGACAAGTCTAGACTACTCGAGAACTAAGCGCCGCGTACTAGGAATAGGAGCCGCAACACAC
Strand-356	ACATCCAACACTCTACGCCCAGGAGTTACAAGTAGAGTAGACAACTCCTAAGGTAAGCTCGGAGTACGAGCGCGACGACTCGAACTCTCTAGTAAGGAAGGTACGGAGACGCCGTAAGCGGAACTCGACTACTCGGACAAGCTCGAACGACGAGACAACCTAGGTAAGCGTTCTAAGGAGTCGGAACTCGCTACGCTAGCTAGTTCGCGACGTTAACCGTACCTAGACTAGAATAGGAGCCGCAACACAC
Strand-357	ACATCCAACACTCTACGCCCACCAAGAGTTCGTAAGACCTCGCGAGCGTCAAGTCGAACGGTAGTACGGAAGCGTTACTACGCGTCGCTAACCTCGGAGACGTCTCGTTCTCGAGCTAGAGGTAGACGTAGACCGTTCGCTAGTAAGCTAAGAGTAACGGTACGAGACTACCTCGGCGGAGAGACTACGGCGGAAGGTAGTAAGCGAGTACCGCTAGGTAGAAGAAGAGAGAATAGGAGCCGCAACACAC
Strand-358	ACATCCAACACTCTACGCCCGAACGAGACGGAACGAAGTTACCTACGGAACTCCTCGGCGCCGTCGGCGCGTAGGAAGCCTAAGCTACTAGCGAACTAGAGTACAAGAGTAGCTAGACCTACGTCGGTACCAAGTAGACTAGGACGGAAGCCGCCTACTCGTTAACTACGAGCGGCTAGAGGAGCAAGAGTACTAGACCTAAGAAGTCGTCGAGCGCGTACGAAGACGGTGAATAGGAGCCGCAACACAC
Strand-359	ACATCCAACACTCTACGCCCACTACGAACCTACCTCGAGAGTAGGAACTAAGTCTAAGACAAGTCGAACGCGCGACCGCGAGTACCTACTACCTACGACAAGCGAGTAAGACCTAACGAACTAGGAGCGGAACCGGAACTACCGTAGAGAGCTACGCGAGCGCTACGAGTCGGACCGGCGGTTAGTAGAACGCGACCTCGTCGTAGTACTCGTAGGTCGACTACCGTACTGAATAGGAGCCGCAACACAC
Strand-360	ACATCCAACACTCTACGCCCAGTTACAAGTAGAGTACGTCGGAAGGACGCGGACAAGGCGAACAACAAGCCGCCTCGTTCCTCGTCCTCAAGACCGTAAGTACCGAACGCAACGAAGCTCGACTAAGACAACTACTACGCAACTCGGAAGAGAAGAGGAGTAGGACGACGAGAGAACTAAGTTCGAGCGCTCTAAGCTACGCTCTCGGTACTCGGTCGTACCTCGCGTCGGAATAGGAGCCGCAACACAC
Strand-361	ACATCCAACACTCTACGCCCAAGAGTTCGTAAGACTACTAAGAGACGAACTAACTCGTCGGAGACGGAACTAGAACGAACTCGTAGTTCTAGAGAAGAAGAAGTTAAGAACTACAAGCCGAACTAAGATCGGAACGCTACGGCCTCTCGAGAAGAGGTAGACCTAGAGAGGAACAACTACGAACTCTCAAGGAAGGAAGGACCGAACTCCTCGCGAGCCTAGAAGAGAGAGAATAGGAGCCGCAACACAC
Strand-362	ACATCCAACACTCTACGCCCTCGAACGGAACGAAGAGCGCGAGGTCGTAAGAAGCGTAGACGTCGTTAAGCTCGAGTAGTTACGCGTACGCTCCTAGGAGGAGTCGGAGTAAGTTAAGTAGGACGAGGAGTAGGTAGAACTAGAGGACCTCGAGCAACTAGGTCTAACCTACCGGCCTCGGCGCTCCTACGAACTAGAGAAGCTAGACGAAGTAACTCGGTCGGACCGTCGAATAGGAGCCGCAACACAC
Strand-363	ACATCCAACACTCTACGCCCACGAACCTACCTCGAAGGTACGCTACGAGCAACGGTAGTACGAGACTCTACAACTACGAAGAGTAGAACAACTACTAACGACTCTACTCGAGTACTACCTACTAGACGTAAGAAGCGAGCTCGTTCGAACGCTAACTCGCCGCTCGAAGCCTCGCCTAGAGTAGTAGGCGGAGGAACGGAAGACTACTCTAACGCGCGTAGAGTTAGTTAGAATAGGAGCCGCAACACAC
Strand-364	ACATCCAACACTCTACGCCCTACAAGTAGAGTACGACCGGTAGTTCGAGGCGGACTACCGTAACCGGAAGTAGCGCGAGAACTCGGTCGTTAGACAAGGAACTCTACGCCTAACGCGGAACTCCTAACAACAACGGCGGAACCAACGGAAGCGGAACCGGACAAGCGTCGCTAGACGCGTAGAGTAGTTACGGTTAGTTAGAGACCGAAGTACGAACTACTCGGAGCGCGGAATAGGAGCCGCAACACAC
Strand-365	ACATCCAACACTCTACGCCCAGTTCGTAAGACTACTAACGCGCCGGAAGGTAGTTCGGCGGTACGTACGGAACCAACCTCGCTAGTAGTAGACTAAGGACGTTCGGACGCAAGTCGAGACGCTCGAAGTACGTCGAACTAACTCGACTCGGTCGGAGTCTAGAGTAACCTAGCGGCTAAGACGGAAGTAGAGTTAACGCGTTAACGAGAGAGACTAGGACTAAGTTCAAGGAATAGGAGCCGCAACACAC
Strand-366	ACATCCAACACTCTACGCCCAACGGAACGAAGAGCGGAACGTTCGGATCGAGTTCGTTCTAGACGACCGTCAAGACTAGCGGCTAACGCGCGAGCGGCGCTACCAACGCTAACGAAGCGAGTCTCGCGTTACTCGCGACTCTCGAAGTCGTCTCGAGTTAGACTCGGAACTAAGAGACTAGTACGAGAGACTACAAGACGACCGGCGGAAGTTAGAGTCTAAGCAAGACTGAATAGGAGCCGCAACACAC
Strand-367	ACATCCAACACTCTACGCCCAACCTACCTCGAAGGTTACGCCTAAGGACGTACTACTAGTCGAGGTAAGAGGAAGCTAGTAGTTAACCTAGACTCGCCAACGGTTAGTCGACCGTAACCTACTAGAGAACCTCGTACGCGACGAGAAGTAGCTCGAGGAGTAGCGGCAAGACCGGTTACGCGAACTCGTAACGCGCTCAACCTCCTCAACCTCAAGAAGCCTCGACGAGTGAATAGGAGCCGCAACACAC
Strand-368	ACATCCAACACTCTACGCCCAAGTAGAGTACGACCTAGTAACCTAGGAGACAACTCAAGACTACCGGAAGCTCGAACGTCGCCTAGTTCTAGACTACCGCTAAGAAGTAAGACGTCCTCCTCTAAGGTACTCTCAAGTAAGCCTACTCGAGCGCTAACCTCGGCAACTAACGCGGCGTCTAGAGCGGACCTAGTAAGTAACCTAGAGACAAGGAACGCAAGCGCGGTCTCGAATAGGAGCCGCAACACAC
Strand-369	ACATCCAACACTCTACGCCCTCGTAAGACTACTAACAAGGAAGTTAACGCGGACCTCGACCTCGTAGACCTCGAGAGAACGCTAGCGAAGTCGCCGTAGACAAGTTCTCGTCGAGCCTCTACGTCGGCGCTAGAGAGTTCAAGTCGACGGAAGGCGGTCTACTAACGACCGTAGACAACGCCTCGTTACGCGCGAACGGAACCTAGACGTAACTAACGTAACGCGCGTCTGAATAGGAGCCGCAACACAC
Strand-370	ACATCCAACACTCTACGCCCAGAACGAAGAGCGGAACGTTCAACTACAAGTAGAAGAAGACCTAACGACAACTCGCTCTAGAGAAGACCGTACGATCGTAGTCGAGTTCGAACTAGTTAACGTTACTCAACGCCTAACTCGCGTTAAGAACCTCGAACGCGAGTAAGTTCGGACTACAACTAGACTAAGGAAGGAGGACCTACGCCTAACAAGGACGCGTCTAGTAGTCGGAATAGGAGCCGCAACACAC
Strand-371	ACATCCAACACTCTACGCCCTTACCTCGAAGGTTACGCCTAGACGCTCGACTCGGTCTAGAGACTCGCCTCCTCGGTAGCGCCGTTAGGTAACTACTCTAACGCGGTCTACCTAGGAGAAGTACGTTAAGGTAAGGAGAGGAAGACGCCGCCGGAAGTCGGCGGACCTAGTAGTTACGAGAGTCGTTAAGCAACAAGAACTACGGCGCTCGGCGGTTAACGTAACTCGGTGAATAGGAGCCGCAACACAC
Strand-372	ACATCCAACACTCTACGCCCTAGAGTACGACCTAGTAAGACGCCGGTAGCAAGTACAACGCTCGCGCGTTCGGCGGCGCCGCTCGAACTCAACTCTCGAGGTAGAACAACTAAGCTAAGTACGTCCTCGGCGGTTAACGAAGTAGGACCGCGAGGTAGACTAACGAAGCGTAAGGTACGAACGGAAGAAGCTAGAAGTTCGGTAAGTCGAAGAGTAACAACGAACGAGAAGAATAGGAGCCGCAACACAC
Strand-373	ACATCCAACACTCTACGCCCTAAGACTACTAACAAGCGTACCTCGTCCTACTCTAAGCCTACGGTTAGTTAACTAGCGCGACCTAGACCGGAACCAACGCGTAAGAAGAACAACTACCTACTACCGCCGCGAGCTACAACAAGAAGGAACAAGCCGTCAAGAAGTAACGCGTCAACGCGAGGTACGCCAAGTTCGCCTCGTACTAACCTCCTCTAACGAAGTACAAGTAAGAATAGGAGCCGCAACACAC
Strand-374	ACATCCAACACTCTACGCCCTACTCGAGGTTACGCGAACAAGCGAAGACCGTTCTCGCTAGGAGTAGAAGGTAAGAACAAGGTACCTCGAGAAGCAACCTCAACAAGAAGACTACCGCGAGACCTACCGCCGTAAGGAACGTCCTCAAGTAACGACGCTCGAAGAAGTCGTAAGAGTTAACTAGATCGAGTAACGGCTAGAAGTAACCTAGCGAAGGAAGACTCGGACTCGAATAGGAGCCGCAACACAC
Strand-375	ACATCCAACACTCTACGCCCAACTACTAACAAGCGTAAGGCGGAAGTACTACGAAGTTAGAAGCTAGGTAACTCGGTAGCTACGGCCTACTACCTAGTCTCCTCGTCGTCTACGCGTTACGACCTCGATCGGAACAACGCGGCGCGAACCTCGGAACTCGCCTACGACCTACGAAGAAGAGTTAGACTCGCGTTAAGACTCGGTCGAAGAGCTCGGAACGACTCTAAGCTGAATAGGAGCCGCAACACAC
Strand-376	ACATCCAACACTCTACGCCCAAGAGCGGAACGTAGAGAAGGTTAACGTAGTACGGTACGACGTAGAGTAGGAGGTAAGGCGGTTAGAGAGAAGTCGCTAGGACGAACTAGACCGTTCGGTAGACCGTCAACGTCAAGAGGCGGTAGACGAGGAGGTAGAGGTACCTCCTAAGTAGGAGTACGTAACGCAAGTTACCTAAGAAGACGACCGAAGCTAAGAAGTAGAAGAGCGAATAGGAGCCGCAACACAC
Strand-377	ACATCCAACACTCTACGCCCTCGAGGTTACGCGAACTAACCTACTAGTAACAAGAAGAAGAAGGTAGCTAGAGGAGACAACTACCTAGCTACCTAACCGGACCTACCTAGACCGTCGGACAAGGAAGTCTACTACGAAGTAGAAGGTCGACGTAAGTCCTCGCGAACGGAAGTAAGACGACTAACCTCGGACTACTCAACAACTCGGAAGGAAGGTAGGTCGGATCGAGTGAATAGGAGCCGCAACACAC
Strand-378	ACATCCAACACTCTACGCCCACGACCTAGTAAGCCTACTAAGGTAGGAGACTAACTCGAGAAGCGTTCTAGACTCGGTAGACGTCGTCGACGTAGTTCGGCTACGTCGTCTACGAAGGCGAAGCGAGGTAGAGTTAGAGTAGTTAAGCCGCCGGCAACGGCGGAGAGACCGCCGCGAAGAGCGCTCAAGCGGTCTAGTACTAGAGCGTCCGTTACTAAGACAACCTCTCTGAATAGGAGCCGCAACACAC
Strand-379	ACATCCAACACTCTACGCCCTACTAACAAGCGTAAGGCGGAGACGCTCAAGCTAGCGAACAAGAGGAAGCGTACGGCGCGAGCGGTTACGAAGCCTAGAAGAGGACCGTTAGGAGATCGAACGAAGGTAGGAGGAGAAGCGCCGCGTCGACTAGGACGACCTCGAGTAGTAGTTAGAGTCTCAACCTACTAGACTCGAACTACGCTAGTAGACAAGCTAGTACGACGAGTGAATAGGAGCCGCAACACAC
Strand-380	ACATCCAACACTCTACGCCCAGGTTACGCGAACTAACTAGTCTCTCGACTCGGTAGTTAGAACGAGACCTAACTACTCGGCGGTACGCGTTCGTCCTACGCGCGACGAGAAGGAAGGAAGTCGCCGTTCGGTAAGAGTTAACTCCTACCTCGGAAGCGACGGAAGTCGGAACGTTACGACGCTAAGCTAGTTAAGGTTAGAACGAAGCGGCGTTAACCAACTACTAGACGGAATAGGAGCCGCAACACAC
Strand-381	ACATCCAACACTCTACGCCCACCTAGTAAGCCTACGGCAAGTTACGAAGCGCTAAGTACTCGTTAAGGAACGAAGAGACTAAGTCGTTCTAGAGGAAGAGCGGCTACGCTCTCCTCGGTCGGACCGCGAGAGAAGCGTTCCTACTCCTCTCGTAACTCGAACTAACTAACAACTAAGTTAAGACCGTAACTAGCTACGGAACTACTCGACTCTCGAACGCTACTCGGACCGAATAGGAGCCGCAACACAC
Strand-382	ACATCCAACACTCTACGCCCTAACAAGCGTAAGGCGTCTCGTACGCTACTACGAACTCGAAGACCTACTACTAAGGTTACAACGGTTAACGCTAAGGCGCCGGCGCGAAGAACCTCGCCAACTAGAGTTCGTAACAAGGTAGTACTACCGCCGAAGGAGAACTAACCGGCAACGCTAGATCGAGCGGAAGAACGAGTAGAAGTAACTACAACTAACTCTAGAGCCTCGCGGAATAGGAGCCGCAACACAC
Strand-383	ACATCCAACACTCTACGCCCTTACGCGAACTAACTAGCGGAGAAGGAAGCTACGAACCTCTACTACTCCTAGACTACGCGTAGAAGACCTCGACCAACCTAAGACTAGAGAGGACTCTCGAACGCTCGAGGAAGAGCCTCTAGAGTCTCAAGTAAGTCGGAGAAGCCGCCGCGAACGGTACGTACGAAGGTAAGTAAGCTAGGTTAGAAGAGTTAAGCTAGACCTAACGCGAATAGGAGCCGCAACACAC
Strand-384	ACATCCAACACTCTACGCCCTAGTAAGCCTACGGCGTCTCGAAGTCGAGTTACGAAGCCGTTCGCGTCTAGAGAAGCGCGTAACAACGCCTCGCGTCGAGGCGGTTCGCCGGCTACGAACGCTAAGGAGAAGGTAACGAAGGCCTAGAGTTCTAAGTCGCCGTACAACCTCAAGCCGGAAGACTCTAGAGTAGTTCGAGAAGAACTACTACTACCTAGAACGGTTAGAGGGAATAGGAGCCGCAACACAC
Strand-385	ACATCCAACACTCTACGCCCTAAGCGTAAGGCGTCGCTCGGAGACTAGAAGCCTACGTCTAAGGAAGGTCGACCGCGACGGAAGAGAAGTAAGGAGTCGTCCTAACTAGGACTAACTAACTAGAGTCGACGACTAGACTCAACGCTCGCCTAACGGAACGCTACGTCTCGTTCGGCAAGTAAGCGTTAGAGACCGCGGAACAACTACCTCGCTAGAACTCGTTAACTCGAGAATAGGAGCCGCAACACAC
Strand-386	ACATCCAACACTCTACGCCCACGTAGAGAAGGACTAGCGGTTAACTCGGCTAAGAAGCTCGAAGAAGTTACGCCGGCGTCCTCGGAGAAGCCGCCGTAGAAGGCGGACAAGGCGTCGAAGGTAACTCGAGCGTCAACTACTACAAGGAACAAGGAAGCGCTAGACAAGGCGCTCGCGCCGAACGCGCGAGTTAGTAAGCTCTAAGGTCGAGAACGTTAAGGTAAGACGTAGAATAGGAGCCGCAACACAC
Strand-387	ACATCCAACACTCTACGCCCTAGGAACTAACTAGCTCGAAGACGAGCAAGTAAGCCTCGAGGACGACGAACGGCGTCTAGTCGTAGACGTAACTCTAGAGCAAGCAAGGACCTCAACCTACCGCGACTAACGGTTAAGGTTCGACGACTAAGTTCTAAGACAAGAGCAAGTAGACCGGCTAAGAGAGGTCGACTAAGAAGACGCCGACGACCGTTCTAGAACAAGGCGCTGAATAGGAGCCGCAACACAC
Strand-388	ACATCCAACACTCTACGCCCTAAGCCTACGGCGTCGCGTTAAGCGGCAACCTCGAAGAGTAGGAAGGACTAGACAAGTAAGCCGAACTCAACCTACTCCTCCTCCTAACTAGCCTACTCGAACGCTACGCTCTCGGTCTCCTCGTAGAGTAGAGTAGGTACTAAGACCTACTAAGGTTAACTAGAGACAACTACGCGACCTCGTCGTACGGACAAGGTAGCTAACGCTCGGAATAGGAGCCGCAACACAC
Strand-389	ACATCCAACACTCTACGCCCTAGAGAAGGACTAGCGAAGTCCTACTACTAACGAGTTCGACCGCTCAAGCGAGGACCGTCGCTACTAACGCGGAAGCGTAGTAAGAGAACGGTAACCTACGACTCTCGTACGCTAGGACTCGCGCGTCGACGGAAGAAGTCTAAGAACAAGCTAGAAGGTACGTCGTCTCGACGAGATCGTTACTACAACGAAGAAGCGTCTAGAAGTTCGAATAGGAGCCGCAACACAC
Strand-390	ACATCCAACACTCTACGCCCGAACTAACTAGCTCGACTAGCGGCCTAAGCGGTAGGAGCGTCTAACCTCTACGAACGAAGTACCTCAAGACTACCTAACGACTCTACTAGACTAAGTAGACCGAAGCGAGAGAAGTCGTCTAGTCGGAAGACTACGCTAGGTCGAACTCGACTCGGTACCTACGCCGCGCTCGACCTAGGACCTCGAGGTACGGTCTAGAGAGCTCGAGGGAATAGGAGCCGCAACACAC
Strand-391	ACATCCAACACTCTACGCCCACCTACGGCGTCGCGAGCCTCGGAACGTCGTAAGCCGTACTAGAGTCGACGAGGTAAGCCGGCTAAGAAGAAGAGTTCAAGTTCTACGGTAGGTAGAGGTCGAAGAGCTACCTAAGGTAGTCGAGCGGTAAGTAACTAGAGTAGAGGTAGAAGAGGTTACTCGGCGAAGACGCGGAAGCCGCTCTACTAAGTACGTTCGGTTACAACGCGGAATAGGAGCCGCAACACAC
Strand-392	ACATCCAACACTCTACGCCCTAAGGCGTCGCTCGCTCGTTACTACCTAACGGAAGTAACTAGAACGGAGACTACGCTAGTAACAAGAGTAACGCGTTCGCTCTCAACGTCTAGGAACAACCTCAACAAGCTCGGAGTCTAAGAAGAACCTAACTAGACGGTAGTACGACCGGCGGCGTCGGTACGTACCTAAGCGCCTAAGTCGGCGTCTAGTAGAGTCGGTAGTAGTCGGAATAGGAGCCGCAACACAC
Strand-393	ACATCCAACACTCTACGCCCTTAACTAGCTCGACTCTACGAAGGTACGAACAACAAGGCAAGAAGTTCCTAGACGCCGCGTTCTAGTAAGGATCGTTAAGAACGAGGAGTACCGCTCCTAGACCTCGAAGGACCGTACGAACTAGTTAACCTACCAACGGAAGGACGTTACTACGCGTCGGACAAGCCGTCGCGTACCTACGAACTCCTCGGACGAGCGCTCAAGAGTAGGAATAGGAGCCGCAACACAC
Strand-394	ACATCCAACACTCTACGCCCTACGGCGTCGCGAGCTACGAAGAGAACTACAACTACAAGAGACAAGGAAGGACCAACCTCTACGCCGGTTAGACCGAAGAGAGTAGCCTAGAGACCTAACGAACTCCTAACGTCTAGTTACAAGCGAGCGGCGAAGCGAGGTCGAAGAAGTAAGCCGCCGTAACCGGTCGGTTCCTCGGTCTCGTCAAGACGTAGTCGTTAACTAGAAGAGAATAGGAGCCGCAACACAC
Strand-395	ACATCCAACACTCTACGCCCAGCGTCGCTCGCTCGAGCGGTAGACCTCCTCTCAACAACTAGGAAGCCGGCGCTAACTAGAGGTCGTAGAGCTACTACAAGTTACGCGCTCGGTTAACGTAAGTCTAAGCTACCTAACTAAGGAGTACGTTAACCGCTCGGTAACCTAGACGCCTCGAAGGTAGAGACGGCGCCTCCAACTAGAGTTCGTAGTCGAAGTACGCGTCGTAAGAATAGGAGCCGCAACACAC
Strand-396	ACATCCAACACTCTACGCCCAGGACTAGCGAAGGATCGTACTAAGGAACGAAGTAGGAAGGTACCGTAACGAAGAGGTACCTCTCGTACAAGACCAAGAGTAGAGAGTTCGGTAGGACCTCGACTCGGAACCGGAAGAGTTAACGCCTCTAGTAAGGCGCGAGGACGAGCGGTAACGTCTAGAAGTAGTAGACTAGAGACGTCGGCGGCGTCTACGGAACCGCGACGAGCGAATAGGAGCCGCAACACAC
Strand-397	ACATCCAACACTCTACGCCCACTAGCTCGACTCTAAGAAGCGCGTAGACGAACGGTACGTTAGACGAAGGTAGAGAGTAACTCGCTCAAGAAGCGAGACTCGCCGTTCGCGAAGAACCTAGCGGTCGGTAGACTCGGACGAACGTCTAAGGTAAGTTAACTAGTCGGTAACGAGAGAGGACGAGTTCGTAGTAGTAAGCGAACGCGTACCTAACCGCGACTCTCCTAAGCGAATAGGAGCCGCAACACAC
Strand-398	ACATCCAACACTCTACGCCCAGCGTCGCGAGCTACCTCGTCTACTCGAGGTTACGAAGGAGACCTAGAACCTAAGAGTAAGGCGGCTAAGGCTCGACCGCGACCTACGGAAGGACGTTCGTCTCGAACGCGTAGTTCTCGTCGAGTTCGTAGAACTAAGGAACGTTCTAGTACTACGCGACTAGAGAAGGTAGACTAGACAACGAAGTCTACGGCTAACGCGGTCTCAAGGAATAGGAGCCGCAACACAC
Strand-399	ACATCCAACACTCTACGCCCAGGACTCGCTCGAGCCTAAGCTAGTTCAAGAGGAGAACTAGCCTACCTACTCGCGCTCCTACGAACAAGAGCAACTACAACGTCTAAGGAACCGCCGGCCTCTAGTTCAACTAAGACTACGGTCTCTAAGGCAAGAACGGAACCTCGGAACCTCGAAGCGGTTACGCCGGATCGACGTAGTAGACTCTACGAAGGACTAACCTCCGGAAGGAATAGGAGCCGCAACACAC
Strand-400	ACATCCAACACTCTACGCCCACTAGCGAAGGATCGTAGTCGGAAGCGAGGACGTCGACGAAGAGCGCGTAGACGAACCTAACCGTTAAGTAGAGGACGACTCGACAAGAAGAGTTCCTAGAAGGAGAAGGCGGTTAAGACGCTCGACTCGAAGAGAGGAACGCGACGTCGTTACTAAGGAACCTACTCGTCTAGACTAACGCTACGAGGTTCAACGTCGTCGGATCGAGGGAATAGGAGCCGCAACACAC
Strand-401	ACATCCAACACTCTACGCCCAGCTCGACTCTAAGAGAAGGAACTCGAGACTCGAGTAGACGCAACGCTAGTAGTACGAGTTAGTACGGCTACTAGAGTAGAAGACGCTACGCTCGGAACTACGGTACTAAGTACTCCGAACGAGAGACTCTCTAAGCCAAGACTAAGTAACAAGTCGAAGGAGCTCAAGTCGCTAAGAAGTTAACGACCTAGAACAACGCGAAGAGCAACGAATAGGAGCCGCAACACAC
Strand-402	ACATCCAACACTCTACGCCCAGGACGAGCTACCTCGCTAGGTAGTCGGAACTAACTAGCTCGTACGCTCTCGGTACCAACCTACAAGCGAGTAAGTTCTAGTTAGAAGCTACGTACTACGCCTACCTAACCGCTCAACTCAACGCGACGAGCGCTAGCGGCGTCTCGTCGTACTAAGGTTAGTACGCTCCTACGAGCAAGACCGCGTAAGCTAGTAGTAACGTCAAGAGGGAATAGGAGCCGCAACACAC
Strand-403	ACATCCAACACTCTACGCCCACTCGCTCGAGCCTAAGTACCGAAGCGTACTCGACTCCTACGTCGTAGAGACTACTAAGACAACTACCTAGTACCGCTAGACTAACTAAGAGTAGTTAGTACTAAGAGAAGAAGACCGGTAGCCTAGGTTACGGAGAGTTCTAACTAAGTCTCAAGAACAACGAACCTCGAAGGTCGTAAGAACTAAGGAGGAGAAGTAACCTCGGCGTCGAATAGGAGCCGCAACACAC
Strand-404	ACATCCAACACTCTACGCCCAGCGAAGGATCGTAGAACTAAGCTCAAGTCCTCGGCGGTAGTCGGTCGAGTACTAAGAGGTTCGAAGAGTAAGCGTTACTAACCTACTCGAGTTAGACGAAGGAACGACAACGCGCCTACAACGGCGGAACTAGGTACTAGAACTACGCCTAGAGGTAGTTCGTCAAGTTCAAGTCGTAACTCGCGTCGAGAACGAACGGCCTCCTAGACGAATAGGAGCCGCAACACAC
Strand-405	ACATCCAACACTCTACGCCCTCGACTCTAAGAGAAGAGGAACGCGGTTAACTCGAAGCTAAGTTCCTCCTAAGTAAGACGGAACGAAGTAGTCGGACCGAACTCCTCTACCTCGGACTCGAACTAGACTACGAACCTCCTAGGTTACTCCTCGGAAGATCGTACAACGCTACGACCTACGGTTCGTTCGTCCTAAGTTAGTAAGGATCGAACGCCGTCTCGAACGGCGTCGAATAGGAGCCGCAACACAC
Strand-406	ACATCCAACACTCTACGCCCTAGTCGAGCCTAAGTACGTAAGCTCCTCCTACTACTAAGAGTTACAAGTAGAACGAAGCCTCGAGGAGGTTCGCCGTCTACGTCTAAGCGAAGTTCGGCAAGACGAACGCCAAGTACCTAAGGAGAAGTTACGGCTAAGACCTACGACCTCGCAAGACCGTTCGCAACGGTTAGACGGAAGCCAAGAAGAAGTAGAGCTACAAGTTCTCGGAATAGGAGCCGCAACACAC
Strand-407	ACATCCAACACTCTACGCCCGAAGGATCGTAGAACTAGGAACGCGCGAGTACTCGGTTCGAAGGCGAAGCCGGTACTCAACAAGACCTAAGGTACTACGGAAGTCGGAGAGAGGAAGCGAGAGAAGCGACTAGTAGTACTCGACTAGAGAACCTCGCGAGTAACAACAACAAGTTACCTAAGAGCGTCTACGCTCAAGACAAGAGCGCCGGTTAACGAAGTCTAAGGAACGAATAGGAGCCGCAACACAC
Strand-408	ACATCCAACACTCTACGCCCACTCTAAGAGAAGAGTAAGGCCTCGAAGGCCTCCGGTTAACTAGAGAGTACTACGAAGCGTCGACTAGGAGTCGGAAGGAAGCCGGAGAAGACAAGAGTTAACAACTACAACTCCTAGACTAGAGGTAACGACTCTAACTCGGAACGTTACAAGTCTAAGGATCGAGGTCGAGAGAGAGAAGCCTAGAGTAGAGGTTAAGAACGTAGGAAGAATAGGAGCCGCAACACAC
Strand-409	ACATCCAACACTCTACGCCCAGCTACCTCGCTCGAAGATCGTTACCTAGAACCGGAACGAGGAGCTAGTCGTAAGTCGAAGGAAGAAGGAGCTCGAAGACTCGCCTAGAAGACGCTCTAGAGACTAGGTTCGCGTAACTCGGTTACGAAGAGAGGACTAAGAACGTCGCGTAAGTCTCGTAGAGCTCGTCGAGTAACGGTAGCTCGAGCGAAGACTACAAGTAACGAACTGAATAGGAGCCGCAACACAC
Strand-410	ACATCCAACACTCTACGCCCTCGAGCCTAAGTACGTTACAAGGCGCCTCGAGGAGGCGGAAGTAGTAAGCGACGACCGTACGACCTAGACGCTAGAGTACTCGGAACTACAAGACCGCTAGTCTAACCGGCAACTCGAGACTCTACCTAAGGTACTCGAGCCTCGGCGAACGCGCCGGAGAGTACCGACAAGAGACCTACTCGACTACTACTAGGTACTAAGAGACTCAAGAATAGGAGCCGCAACACAC
Strand-411	ACATCCAACACTCTACGCCCAGATCGTAGAACTAGTAGAGAAGGAAGTTCGCCGGAACGGAAGAAGCGAGGAGTAACGGTTAGAAGTCGACCTAAGGCTAGTTACAACGAACTCGGACTCCTCGACTACGCGCGTAGACCGCGAGAAGCGCCTACTCGAAGAGGTACAACGGCTCGAGTACCGTCAACGGACCTAACAAGAGCGCTCGAAGGTCGTAGAGAACCGTTACCGAATAGGAGCCGCAACACAC
Strand-412	ACATCCAACACTCTACGCCCTTAAGAGAAGAGTAAGAACTAACTAACGGAAGTAACCTAAGCGAAGCTCTACAACGCCTCGGTTAGTAAGCTCCTAGTAGCTAGTTAAGTACCAACAAGACGAAGAGAACCGGAACCGGTACCGGAAGCAACCTCGCTACCGGAACGTAACAAGAAGCTCGAAGAGAGTTACCTACTCCTAGCGCGTTAACCGTACTCTACGGCGCCGTTGAATAGGAGCCGCAACACAC
Strand-413	ACATCCAACACTCTACGCCCTACCTCGCTCGAAGAACCAACTAGTCGTAACGCGCTCTCGCCGGAAGTTAAGGTTAGTTAGAAGTCAAGAACTCGAGTAGAGAGAAGAGACTCTAACTCAAGACGAACTCGGAAGCTAGACAAGCTACCGAAGGCGCCTACAAGGTCGGTAGAGAGGAAGGTTAGACGACTCGAAGCGCGAGATCGTCGAACAAGAAGACGTAGAGACCTGAATAGGAGCCGCAACACAC
Strand-414	ACATCCAACACTCTACGCCCAGCCTAAGTACGTTAGAACGCCTCGGACAACTACGCTAAGTCTAGAGGTAAGAGTACCTCGAACTCGCGAGACTCGGCTAACTACCTACCGGCCTCTCGTTAGACGGCGGAACCGTCGCTAGTAACGGTAGGACGAAGAACGGACGCGCGTAACGCAACTACTACCTACGACCTCCTAACCTCTACTACAACTAAGAGCCTAACGCGGAAGAATAGGAGCCGCAACACAC
Strand-415	ACATCCAACACTCTACGCCCTCGTAGAACTAGTAGACCGGACAACTAAGTACGAGTTCGAGGTCGTAAGGATCGAGCGAAGGTAGATCGTTAGAGTCGTAGAGAAGGAAGAACGGTTAAGCCGAAGCGTAACCTAGCTAGACCTAAGTCTAGTAAGCTCTAGAACTACTAACTCAACGCGGTTCGAACGGTCGGAGCGGCGCCTAACTACAAGGTACCTACGCTAAGTTCGAATAGGAGCCGCAACACAC
Strand-416	ACATCCAACACTCTACGCCCAGAGAAGAGTAAGAAGAACTCGCGTAGGAACGCTACTCGAGTACCTAGAGAAGCGCTAGAAGGAGGAGCGGTAGCTCGTAACTAAGGCGGAACTAGAGAGACCTACTAAGACAACAAGTCAACGGTAACCTCGCGAACGCTAGGCGGCGGTAAGAAGGCGCCGGAGACGGAGAGACCAACGCCGTCGTCTACGGAAGAGAAGCCTAGGAAGAATAGGAGCCGCAACACAC
Strand-417	ACATCCAACACTCTACGCCCTTAAGTACGTTAGAACAAGAGTAGAACGGAAGATCGAGTTAAGCGGAAGAAGCGAAGAGTTACGAAGCGTAGTAGTTAAGTAGAAGTACCGGAGAAGCTACGAAGAGTAAGTCGTTCGTCGCGAGCGTCTACGCCGTTCGGTACTAGAACGGTACGTACGTCGCCGTCAAGAGATCGACGACTCCTCGGTACAACAAGAAGAACAACGCTGAATAGGAGCCGCAACACAC
Strand-418	ACATCCAACACTCTACGCCCTAGAACTAGTAGACCGCGTTCCTCGGACAACCTAACAAGTACTAGAGAGAACGCGTCGCCAACGCGACTAGGTTCGGATCGAGCCTACAAGAGTCGACTCGCGGCTAACCTCGCGCCGCGAGAACGAAGAGGTACGGAGAACTACTAAGTACCGCTAACTCGTTAACTAGACAACGCGCCGCCGTTCAACGTTCGGAAGCTCTCAACCGTGAATAGGAGCCGCAACACAC
Strand-419	ACATCCAACACTCTACGCCCGAAGAGTAAGAAGAACGCTCGTAAGCTACCGTACGCTACGGAACCGAAGCGAGGACGTACTACAACGCCGTTCCTCGGTACGCTACCTAGACCGTTACGACTACGTACGGAAGACAACTAGAGAGAAGACTACGCGGAACCGCTAGGTTCGGCTCGTAGTAGTCGTAAGGTACTAAGAGTACGAACAACGGTAGTACGTACGCGTTCAACGAATAGGAGCCGCAACACAC
Strand-420	ACATCCAACACTCTACGCCCACTCGAAGAACCGCCGAACAACGAAGACCTCGGAAGTCGTTAACTACGTCGCGGAGGAACGGCGTCGCGGAAGCGTAGAAGACTCCTACGAGTCTCGGACAAGGTTAACCTAAGACGAACAAGAGTCTACGCTAGTTACGAACTAACGAACCTACGTTAAGCGCGACTCAAGGCTAGTTCCTAGAGAGGTCGGAAGCCGGAACGTAGAACGAATAGGAGCCGCAACACAC
Strand-421	ACATCCAACACTCTACGCCCAGTACGTTAGAACAAGCCGCGACGAGCCTAGAAGTCTAAGGAGACGTCTAAGGTCGGTTAACTACCGGCTCGACCTACCTAAGCTCGTAGTACGTCGGCTAGAAGAGTCTAACTCTCGGCGCCGTAACCTACGCCTAGAGCGGAAGCCTCTCGTTCTAGACGTCGGAAGTCGGTTAGTTCGGAACCAACCTCGCCAACTAAGAGTACTAGGAATAGGAGCCGCAACACAC
Strand-422	ACATCCAACACTCTACGCCCAACTAGTAGACCGCGGAAGACGGCGCGTTCGGTTACGCGAGCTAACAAGCGAAGAAGACCGTAACCGGTAACGGAACCGCGTACTACTCGAACGAAGGACTAAGGACCAACGCGTTACGCTCGACTAGTAGGACGAGTAGGAGAAGAAGAGAGAAGTACTACGTCGCGTTCCTCGCCTAACCTACTCTCAACGCTAGGTTACTAGAAGTCGAATAGGAGCCGCAACACAC
Strand-423	ACATCCAACACTCTACGCCCTCGAGAACCGCCGAAGGTAGGACTAACTAAGCTAAGAGACTACTCGCCTACGGTTACGCCTACAACTCGTTAACCGGCCTCCTACGAAGCGTCGGTTACCTCGAAGACGGACAACTCGGACAACAACGAAGATCGTAGAGTTAGTAAGAGAAGAGTAGAGACGCCGCGACCTACAACGTCGGTAGGACCGCCTCGAGGCGGTTAAGGTTCGAATAGGAGCCGCAACACAC
Strand-424	ACATCCAACACTCTACGCCCACGTTAGAACAAGCCAACGCTAGTAGGCGGACTAGTCGGACCGCTCGCTACAAGAGACTAACTAGCGCCGGCTAGAGTTAACCTAAGACGAGTTACTAAGCTAGGTTAAGGCGGAACTAGACTCGGACTAACGCTACCGCTAGTACTAAGAGTACCTACAAGTCGACCTAACTAGACGGCGGTAGACTCTAGAGGAGGTACGCTCGGAGAGAATAGGAGCCGCAACACAC
Strand-425	ACATCCAACACTCTACGCCCTAGTAGACCGCGGAAGACGGCAACTCGTTACTCGCCAACGGACGCTAACGAACTCTCGAAGGACTCCTAACCAAGAAGAGTAGCGGAACGTTCGCCTAAGCCGCCGTCCTAGAACAACGAGCTCTCTCGAGGACGGAAGAGGAACCTCGGAAGGTCTCGTTCAACCTACAAGGTTAGAAGTCGGAACAACGTAACCTACCTCGCGGCTACGAATAGGAGCCGCAACACAC
Strand-426	ACATCCAACACTCTACGCCCTAAGAAGAACGCGCTAAGTTAACCTACGAAGGACCTCCTCCTAACGGCGCTACTCCTAGCTAGTAAGTCGGACTAACCAACTAGAACGCCGGACCTCTCTAGTTCGGTCGGACGACTAGACGCTAAGCCGCCGTACGACAAGAAGAACCTCGAAGAAGCTAAGCTAGATCGAGTCTACTAAGTACCTCGTTCTCGAGTAACGCCAAGACCGAATAGGAGCCGCAACACAC
Strand-427	ACATCCAACACTCTACGCCCAGAACCGCCGAAGGTTCGAACCTCGCGAGTACGAGAACGTTCTAGAACTAGGAAGCCGTTCTAAGCAAGTAGTACGGTACGAGAAGACCTCCTAGACGCTAACTCGGTAAGAGGACTAACGCCGTAAGAACGAGGAACCTCTCGTAGAGAAGTTACGGCTCGTTCCTACCTCGAGAACTAACTAGTTACCTAGAACGCTAGAGGACCGTTGAATAGGAGCCGCAACACAC
Strand-428	ACATCCAACACTCTACGCCCTTAGAACAAGCCAACGCGAAGTTAACGAGCGGAAGCAACTAGTCGAGACTCGGAACCGAAGCCGTCGGTAGGTAAGCTCCTCTAGACAACTCGTTAAGGAGGAGAAGGAGTAACAACGGCGCGAGAAGTTCGACTCGGTCGAACTAAGCCGTAAGGCGGTCGGAAGGCGTCGCTCGGTTCAAGTAGAGGTACGGCGAACGACTAACTAACGAATAGGAGCCGCAACACAC
Strand-429	ACATCCAACACTCTACGCCCTAGACCGCGGAAGACTACCTCGGCAACCTCGCCGAAGAAGACGTCGAAGACGCCTCGTAACGCTAGTAGAACGTCAAGAGTCGGAGTAGAAGAGAAGCGGAAGTCGGTACCTAAGGACTACTAAGGTAGTAACGCCTAACCGGTTAGACCGGCTCGTAACAACGCGCTAGGTCGTACGGACGCTCGGAAGCGAGCGGTTAACTCTAAGGAGAATAGGAGCCGCAACACAC
Strand-430	ACATCCAACACTCTACGCCCACCGCGGAAGACTACGAAGCGAGCCTAACTAAGGAACCTAGTAGGTAGTTCGGCGGCTACGTCTCGAGAACCGTCTAGACGACTAACTAGAAGAAGTTAGAAGCTAAGAGAACCGCTCGGACTCGGCGGTACGCTCGCCTACCTCTAGCTAGAACGGAACGAACGGAAGCGTTCGGCGCCGAAGGACTACGACCTCGATCGTCGTTACTAGAATAGGAGCCGCAACACAC
Strand-431	ACATCCAACACTCTACGCCCGAACGCGCTAAGAGCGCTCGCGTCTAACTAACGTTCGGCTACAACTACGAAGGACTACAACAAGAGAGGTACGGCGGCGCGACCTAGGAAGTCGAACCTAGTAAGTAAGCCGTCGCCTAGACGTCGTTCGGCTAGAGTCTAACTACCGCGAGGAGACTACCTCTCAAGACTCGGTTCTCGAGCGCGACTACCGGAGTAAGTACTCAAGAGGAATAGGAGCCGCAACACAC
Strand-432	ACATCCAACACTCTACGCCCTAAGCCAACGCGACCGTCTACGTCGGATCGTAGTCGACCTACAACTACGAACTAACGAGTTCGAAGTACGCGAAGAAGAACGCTAGAGACAAGTTCGGACAACTCTCGACTAACGAAGAGAGCGCGGAACGAAGCGCCGCCGAACTACAAGGACTAGAGAGATCGAGTAGAACGAGCGGCGCCGCTCCTCTAAGGACCGCTCTAGAACTCGAATAGGAGCCGCAACACAC
Strand-433	ACATCCAACACTCTACGCCCACGGAAGACTACGAAGCCGCTAAGTTCTAGTAAGAAGCTCTCTCGAGACTCTAACGCGCCGTAGAACAAGGTACCGCTAAGAACGGTACTCTCGCGACTCGCTCGACCTACTAACGAGAGAACGCCGTCTAAGCCAAGAAGACCGTCGCGTAGTACGGTACGAGAAGGACTCGCAACGAACGCGGTAACTACGGTTACGCGTACGGAAGGGAATAGGAGCCGCAACACAC
Strand-434	ACATCCAACACTCTACGCCCTAGACTAAGAGCGCTCGGAGTAGGAACGGTACGAGTAACGGAACTAGGAACGCGACCTAAGCCGCTACCAAGACTACCGCGAGTAGGTTCTAAGTCTAAGAGTTAACCGTTACGAGTAGTCTAACTAGAGAGACGTAGGAAGAAGCCGGTAGAAGTAGGACCTAAGCGAGTTAGAAGCGCCTCGGTCTCGAAGCGAACCTCTAAGAGGAAGAATAGGAGCCGCAACACAC
Strand-435	ACATCCAACACTCTACGCCCGAAGGTTCGAGGAGCGCCTACAAGAGTAGTTACTCGTTCTAAGGAGAAGGAAGACCTAAGAGGTACGGTTCGAAGACGAGCAACGGAAGTACGAACGAACGCGGTCGGAGTAGCGCGACGAAGACGACCGGTAACGCCGCGTTCGTCCTCGGAAGCGGCTACAACCGTAACTCGAGACCTAGTAGCGCCGTAAGATCTAACTCTAGAAGCGAATAGGAGCCGCAACACAC
Strand-436	ACATCCAACACTCTACGCCCACCAACGCGACCGTCTAAGCTAGAAGAGACGGCAACGGAAGTACTCGAACCGCGGAAGTCGAACGCCTAACTAGCGGTTAGTAAGCTAGTCTCTCGTAGGAAGCTCGGAGTTAGACCGTACGCTACGGTTCGAGTAAGTAGTTCGCTAAGAGCGCTACGAGAACGTTCGTCGCGTTAGACGTCTAACGACCTCTCGCGAACTAGAGATCGGAATAGGAGCCGCAACACAC
Strand-437	ACATCCAACACTCTACGCCCGAAGACTACGAAGCCGCGAGTCTACAAGAAGTCGGCCTAAGCTAAGAAGAGAGCAAGAACGCTAAGACCGTTCAACTCGTCAACCTCAAGTACGTCTAGTAACTCTCGTTAGACAACCTCCTAAGTTCGTCGAGGTACTCGAGGTTACGAACCGCGTTAAGTAACGGTAACAAGAAGACTCAAGGCCTCCTCGGCGGCTACTACGGCGGCGAATAGGAGCCGCAACACAC
Strand-438	ACATCCAACACTCTACGCCCACTAAGAGCGCTCGGTAGTAGAGCGCGTCGACGTAACTCGCTAGGTAACGAAGTAGCTCGAGCTCGACCTAGTAGTTAAGTAACGGTAGAGAAGCGACGAGAAGTAGAACGACCTCGAAGAACGGTAGTTAACTCGGTAACCTCTAGACCTACGCCTCGTTAAGCGCGACTAACTACGGCGAACAAGGTTAGACTCGCGGTACCGGATCGGAATAGGAGCCGCAACACAC
Strand-439	ACATCCAACACTCTACGCCCAGTTCGAGGAGCGCCTAACAAGTCGCTCTACAAGGAACCGGCTACCTAAGGACTAGTAAGAGCCTCTAAGTCCTAACTCGAGAGGAACAAGTCCTACAACAAGAAGCCTCGAACTAGTACGGAACCGGAGAAGAACCTCGCTAGAAGGAAGGCGCCGCGACTACTAGGAGAGAACCTACGACCAAGTACGTCCTAGAGTTCAAGTTACTCGAATAGGAGCCGCAACACAC
Strand-440	ACATCCAACACTCTACGCCCAACGCGACCGTCTAAGGAGAAGAGTAACGCGAACAAGGAACTCCTCAACTCAACGTCCTCGGCGCCGAACGCAAGACCGCCGGAAGCGCCAAGAGTAAGACGACCGAAGAACAAGCCGTTCCTCTCGGCGTCGGACTAACTACCGCCAACTCGTTAGACTCGTACGGTTAGTACAAGTTCCTAGAGAACAACTAACAACAAGGTAGCGGTGAATAGGAGCCGCAACACAC
Strand-441	ACATCCAACACTCTACGCCCAACTACGAAGCCGCGTTCGCTAGGAAGACGAGTACCTAAGGTAGTAAGACGGAAGTCGGACTAAGTAACGGCGGCGGTAACGCCGCTACGAGAGACCTAACTCTCCTACCTCTCAAGAGAACCGTACGCCTCGTCGCCTCCGCGTCGTTAAGAGACTACTAAGCTCAAGCTAAGAAGTTACCTAACTAACAAGCCAACGGAAGACCTACCGAATAGGAGCCGCAACACAC
Strand-442	ACATCCAACACTCTACGCCCAAGAGCGCTCGGTAGTTAAGTACTCGGTCGAGTTAAGCTAACAAGAGTAAGTCGAGTAGCAAGAGCCTAACGTACGCCGCTCAACTACTACCTACGTTACGCGGCGGTACCGCTCTCTAGAGTAACGCCAACTAGAGCAACTAAGACTACCTAAGATCGTTACCTCGAAGGACGACGAGGTTAGACGAACTACGCTAGACGTTACCTCAAGAATAGGAGCCGCAACACAC
Strand-443	ACATCCAACACTCTACGCCCTCGAGGAGCGCCTAACGCAACGGTCGGAACTAACTCGCGAGACTCGCCGAACGCGGAACGTACGAACTAGCTACTCAACTCGGAAGTTCGAGAGAAGGAACCTAAGTCGCGAGACCTCAACTAACGACCTAAGCCGGCTAGAGGACGTACGCTACCTAACCTAGTACGACTAGCGTCGCTACCTACTAGAAGAAGACTAAGTAAGGTCTAGAATAGGAGCCGCAACACAC
Strand-444	ACATCCAACACTCTACGCCCTACGAAGCCGCGTTCGCTAGGAACGCCGGCCTACCTCTCTCGTTCGGTACTACCGAAGCCGTACTAACCTACAAGTCGTAGAGGACGGAAGCCTCGAGGTACAAGTTAACTAGACTCGGAAGCGCTACCGGTAGAACTAGAGAGAAGAGCGAAGCTCCTCCTACCGTCGAAGAAGGTAGCTCTCGAAGCGGCTAGACCGTTAAGAGTAGCGAATAGGAGCCGCAACACAC
Strand-445	ACATCCAACACTCTACGCCCAGCGCTCGGTAGTTAAGTAGTACCGTAAGATCGTAGAGTAACCTAGACGCCTACGTCGTCGAAGAAGAGAGCTCGAGTAGTAACGGTTCGTCGAGGAGGACTAGTAACGGCGCGACGAAGAGCTCGAGCGGTACTCTACAAGCGTTAGACGCGAGTTAAGACCTAGAGTAGTACGCCGTAGGTAACGGCAAGACGTAGAGTAGCTCGACCGAATAGGAGCCGCAACACAC
Strand-446	ACATCCAACACTCTACGCCCACCGTCTAAGGAGAACGAAGCCTAAGGTACCTCGTCGCTACTAGGACCGAAGAAGGCTAACTAACCGCTCCTACCGTTCTCGGATCGTCGTTCTCGACGAAGACTACCGCCGGAAGGTCGACCTAACGACCTCTCTACCTAAGTAGTCTAGAACGTTAAGCGTACGGTACTAGGAACAACCTACGCGGAAGAAGTCTACGAGAGAGTAGAGAATAGGAGCCGCAACACAC
Strand-447	ACATCCAACACTCTACGCCCGAAGCCGCGTTCGCTAGATCGTACCTAAGTCTCTAAGAGAAGTTCGTCAAGACCGGTAAGTCGTTACTCGAAGGACGCAACTCGAGTACGACGTAGACCTAGGAAGACCTAAGTACCTACAACCTACCTAGGTACTACGCGACCGAAGGAACTAGTAAGTTAAGAACGTTAGACAAGAACGGTAGCGGTAACCTAGAACCTACGTTCGAAGAATAGGAGCCGCAACACAC
Strand-448	ACATCCAACACTCTACGCCCACTCGGTAGTTAAGTCTACAACGCTAAGGCGAAGACAACTAGTTACGCTACGAACGCGAAGAGTTACTAACTCGGTTCTACTACCTCAACGGTTCGTACAAGACTAGTACGTTAAGCCTCCTCGGCGCTAGTAGGTAGTTAACTCTCTACGCTCGACTAGAGACGACCAACGTCGGCCTCGCCGAAGGAGAGAGCTCGCGGAGAGAGTAGGAATAGGAGCCGCAACACAC
Strand-449	ACATCCAACACTCTACGCCCAGCGCCTAACGCAAGTAGAGAGAAGGCTAACTCGAACGCAACGGTACCGTTCTACAACTCAACTAGTAACGCGCTACTACCTCGAAGACCGGTAGCGCTAACGTCAAGACGAAGTAGTTACTCTACGCGTCGTTAGTACCTAACGGAGAGCGGACTCAACAAGCTCAACAACGAAGCCTCGGAAGCTAACCTCGGTTACAAGCCGAAGGTGAATAGGAGCCGCAACACAC
Strand-450	ACATCCAACACTCTACGCCCAGGTAAGGAGAACGAGAACGAGAGTAAGACGGCTAACTACTAGAGTTCGGCGGCTCGTAGTTACGCCTAGAAGCTCGGTCGTAAGAAGTCGTCGTCCTCGTCGCGAAGAACGAAGGCGCGAGTAGTACTAGCGCTCGCGCCGCTAACCTAGACAACGCGTTAACTACGTACGCTCAAGGTACCGTAAGTAGACAAGCGTAAGGTAGTAGCGAATAGGAGCCGCAACACAC
Strand-451	ACATCCAACACTCTACGCCCGAACGCCTAAGTCTAAGTTACGCTAACTCGACGAGGTAAGGCAAGACTACCGCGTAACTACCTCTACTAGAAGCTAGAACCTAACGCCTACCTAACCTAGAACTAACTACCGTACTCTCGTACGGCTACGAAGACAAGACCTAGACGACCGCGTTCGGCGCGAGTACGAACCTACGCTAAGCGACTAACGCTCGAACGTTAACTCTACAAGAATAGGAGCCGCAACACAC
Strand-452	ACATCCAACACTCTACGCCCACCTAACGCAAGTAGAAGACTCGCGAACGCGCCTACGGTTACCTCAACAAGTACTACTAGTCGTTCGCGACTACGAGTCGGAACGCGGAAGGTCTAACGTACGTCGCCGTCGCTACTCCTACTCGCTAGAAGTTAACTCTAGAGACCTACTAGACCGAAGCTACCAACTAGTTCGGCGCTAGAACGACGAGAGACGTTAGAAGTTAGACTGAATAGGAGCCGCAACACAC
Strand-453	ACATCCAACACTCTACGCCCTAAGGAGAACGAGAAGTCGGCGAAGGAAGTAGTCTCGCCGTAAGAAGGACGACTAAGAGTCTACGCAACGGCGCCTACAAGACCTACTAACAAGCGACGTACGTCGTCGGAACGAGGACTCGGACTAACTAGACGAGCGAACAAGAGACCGTAAGAGAAGAAGGAACCGTCGTCTACTACGGACTAGAGAACGGCGAACTCTACCTCGCGGAATAGGAGCCGCAACACAC
Strand-454	ACATCCAACACTCTACGCCCACGTTCGCTAGAACTACCGTAGAGTAGAGTAACTAAGGCGGCGGACTCAACGTCGAAGACCTCTACTCGACGTTCAAGTAAGAGTTCTCGAAGAGCTCGTTAGACCTCGCCGAACAAGCGTACCTCTAGTTAAGTTAGAGACTAACGAAGACGAACTACGGCGCGACCTAAGCTACGTACTCGTACCTAACTAGGTACGCCGCCGGTAACGAATAGGAGCCGCAACACAC
Strand-455	ACATCCAACACTCTACGCCCTAGTTAAGTCTAAGTTAACTAAGGTTAAGGTAGAACAACGAAGCTAGGACTCTACAACCTCGGAGTAGGAGCGTCGCTCTCCTCGTCGTCTACGTCGGCTAGTAGTTCAACGGCGGAACGACTACGAGAAGCGAAGGACGCGCCGAACGCCTCCTCGGCGGCTACAAGTACGTCGTCTAACCTCGACTACGCAAGTACGCGACTCCTCTAGAATAGGAGCCGCAACACAC
Strand-456	ACATCCAACACTCTACGCCCTAACGCAAGTAGAAGAGAGACAAGAGGACGTCGTCGAGTTAGTACAAGTAGTACCTAAGTTAGAAGAGTCTACTAAGCCTAACCGTCGGTAGAACGTACTAGAGCGGACCTCTCAACGTCGAACTCTCGAACGCGTTCAACTAAGCTCTCAACTAACAACAAGCGACCGCCGCGAGTACCGCGTAACCTAGGAACCTCGAAGTCCTCGGAGAATAGGAGCCGCAACACAC
Strand-457	ACATCCAACACTCTACGCCCAGAGAACGAGAAGTCCTACCTAGAACGAGGTACGGCGGCAAGTTAAGGTAACCTAACTACGGCAAGTTCCTAGAGTTACGAAGAGACAAGTAACAAGGACGCTAGTAAGAAGCTCTCTAACGCTACAAGTCGTACCTCAAGAAGTACTACGCTAAGAGTAGATCGACGTTACGATCGAGCTCGTACAAGACCGCGTCGAGACAAGACGTCGAATAGGAGCCGCAACACAC
Strand-458	ACATCCAACACTCTACGCCCTTCGCTAGAACTACCTAGAGTCTACAACTACGCTCGACCGCCAACGGTAGAGAACTCAAGTTCGCCTAGTTACAACGCGCGACGTAAGCCTACAAGAGGAGGCGGACTCAAGAGTTACTCGCTACGTAGGAACTAGACTCGTAAGGTTACTAGAACGAACTACGAACCGTCGCGAGAACCGTACCTCGGTAGTTCGTCGCTCGAAGTAGAGAATAGGAGCCGCAACACAC
Strand-459	ACATCCAACACTCTACGCCCTTAAGTCTAAGTTAACAACGCGGCCTCGGAACGTTAAGGACGAGCGCGAACGGCTAAGAACTAGAACGAGAGAGGTTCGAAGTCGGACGCAACGGAACCTACAAGAGTAACCTCGGCGCGTTACTACCTCGCCTAACGACCTCGACCTAGTAGTTCGGACGCGTCGCTAGCAACGAAGCGTCGTACGTCGCCTAGTCGAAGACTCGGTACGAATAGGAGCCGCAACACAC
Strand-460	ACATCCAACACTCTACGCCCTAGAAGTAGAAGAGAAGAAGAAGACGCGCGTACTAAGCCGTTCCTCAACGAACGACGAAGTAACGCGCTACTCGGTCGTAACTAGACTCGACCGGTAGTCGGAGTACGAACGCTAGCTACAACTAGTACGCGAGCAAGTTACGCGAACGCTAACCTACGTTCAACGCCTAGTTAAGCGTCGGCGCCAAGAGTAGAAGGACTAAGTACGAAGAATAGGAGCCGCAACACAC
Strand-461	ACATCCAACACTCTACGCCCGAACGAGAAGTCCTACTAAGGTAACGACGCGTCGGTAAGACTACTCGGAGCGTCGAACGACGCTACGCGACGGAACCTCGACTCGCTCCTAACGGCAACTACTAGTTAAGTAGGAGCTACGGCGGCGGTCTCCTCAACTACTAAGGCAACGGATCGGAAGTCTCCGAAGGTACGAAGAGCGGTAGGTTCGGTACTCTAACGAACGTACGAGAATAGGAGCCGCAACACAC
Strand-462	ACATCCAACACTCTACGCCCACTAGAACTACCTAGTACGGCTCGACTCGGTACGCTCTCCTCGGTAGGACGGAAGACGGTCTAAGCGGCGCGACTAGAACGTTCCTCGGCGAAGAACTAACTAGAGAAGTCGGCTAAGGCGGCCTAACCGAACTAGCTCGAAGACTCGGAGAAGGTCTCTCGACTCTAACTACCGCCTAAGAGTTACGACTCTCTAGCGGATCGACTACGGAATAGGAGCCGCAACACAC
Strand-463	ACATCCAACACTCTACGCCCAGTCTAAGTTAACAAGGCGTCGCGAACTAGAGAGAGTAGTTACTAACTAGCGGTAAGTAAGGTTAGAAGTTACGATCGAACTAGAGCGCTAAGTTACTCTCGAGCAACAAGTAAGCCGCGTAAGAAGGCGCGACGTACGAAGGCGCTCGCTACGCTAGTTCGACTAAGTCGACGGAAGCTAAGTAAGACGCTCTCGGCGGATCGTTCTCGGAATAGGAGCCGCAACACAC
Strand-464	ACATCCAACACTCTACGCCCAAGTAGAAGAGAAGAAGGAGTAGCGTCGGACCTAGGTTCGCTCGGAGGAGGTACGTCGGCTAAGCTACTACTACTAAGAGCGTCTACAACAAGAAGAGTAGCCTAAGTAGGAGAGAAGGCCTACCTCGCGCCGCTCTCGCCGTCAAGACCTCGAGAACCGTACGCTCGTAGAGTTAAGACGAAGACGAAGAACGCGTCCGTACCTCGACCGAATAGGAGCCGCAACACAC
Strand-465	ACATCCAACACTCTACGCCCAGAACTACCTAGTACGAAGTCGCTAGGTAACGAGAGTCGAACGGCGGTAGTACCGAAGACTAAGCCGGAAGGTTCAAGTTCTCGAGGTACGCGAGAACTACTCTCTACGCGTAAGGCAACTCGTACGCGTAGAGAAGTAGCTACCTAAGCGTCAAGACTCTAGACAACGGTCTACTCGCTAGAAGAGACGGCGTCTAGAGCGGAGAGAACGAATAGGAGCCGCAACACAC
Strand-466	ACATCCAACACTCTACGCCCTTAAGTTAACAAGGCGCTACTAGTACGACTCTAAGATCGTAGAGCGGACTACAACGCTAGACCAAGAGGACCGTCTACAAGTACGAAGGCCTCTAACCTACTAGAAGCTCGTAGTTAAGGTAGAGAACGAGCGCGTCGAGGACTAGGAACTACCTAACCGTTACCGTACGCTAGAAGAGTAAGTAGAGGAGGAACTAGACCGAGACCGCTGAATAGGAGCCGCAACACAC
Strand-467	ACATCCAACACTCTACGCCCTAGAAGAGAAGAAGGAGTACCGCCTAAGGTACTACGACGACCGGCGTCTACGCGACGACGTAGAAGACCGTCGCCGCGACGTTAAGTAGGAAGAGCCTCCTCTACGCTAACGGCCTAAGACAAGAAGGAAGCTAGAGTTCGACTCGCCTCTAGTACTACGCCGCCGGTAGGACGGAAGACAAGTAAGCGAACTCCGTAGTTCGAACGAGAGAATAGGAGCCGCAACACAC
Strand-468	ACATCCAACACTCTACGCCCACTACCTAGTACGAAGACAAGTAACAACGCAAGTAAGACGCCGTAGAACCTCCTAGTTAACCTAACTAAGCTAGGTAGTTCGGTTAGAGACCTAGGTCGAGAACTAACCGGTACTACGGACGCAAGAGGAACGGCGGAACGAAGTACGGAGAGACCGTAACGTTCTAACGCGCTCCTCTCTACGCCTCGTAGAAGAGCTAGTCGACGACCGAATAGGAGCCGCAACACAC
Strand-469	ACATCCAACACTCTACGCCCAGTTAACAAGGCGCTAACTCGACGTCGGAACAAGGCGGTTACGGTAGGACTAACGGCGCTAGGAAGTAAGAACTACTAAGTAGACTCGGTAACAACGGTCTCCTCGCTAACGCCGGTAGAACCTCGAAGAGTTAACCTCAACGCCTCTAACTAAGACGCTAAGCGACCGCGTACAACGCCGGCTAACTCGCTACTCCTACCTAAGAGAGAGAATAGGAGCCGCAACACAC
Strand-470	ACATCCAACACTCTACGCCCAAGAGAAGAAGGAGTAACGAAGGCGAAGAACGCGGCGCTAGAGAAGACGCCTAGAGAACTCTAGAGTCGTAAGCGGAAGGTAAGAGACCTACTACCGTTCGACAACTCTAGAGACCTAACGCCGCTCTCGCTAGTCTAAGCGGTAGGACCGTCGCTAGGAGCCTAAGTAGCGGCAAGAACGCTCCTCGCCTAACCGTCGCGAAGTTACCTGAATAGGAGCCGCAACACAC
Strand-471	ACATCCAACACTCTACGCCCAGGTTACTAACCAACAAGACCGTCGGTAGACAAGAGTAGTTCGCCGCCGCCTACGCTAACAACGCGACCGCTAGCGCCAACAAGAGTAACTAGACTCCTACTACGTTACGAGAACGCGCTAGTTAAGGCAAGGAAGCCGTTCAAGTCTACAACGCTAGTTACGGTCTCTCGAACGCTCAAGTCGGTTACGTCGAACAAGCTAAGTTAGAAGAATAGGAGCCGCAACACAC
Strand-472	ACATCCAACACTCTACGCCCACCTAGTACGAAGACGTCGAAGCTAACTAAGTCGGCCTCGAAGAACGCGAACTCGCTACCTAGAGTCTACTAGACAAGACGACGAGACTAACGACTCGACTAAGCGGTAGTTACGTCTAGACCGCTCCTCTACGCAAGAGACGCCTAGAAGGAACGTTCGCGTCGACGTAAGAGACGAGAAGCGCGACCGTCGGCGCTCTCTAGTTCTCGGAATAGGAGCCGCAACACAC
Strand-473	ACATCCAACACTCTACGCCCTAACAAGGCGCTAACGCCGCTAGTACTAACCTAAGCCTCGCCTAGAAGAGCGAAGCGACCGAAGACGTCTCGTAACTCGGCTAAGGTTAGAACCTACCTAGGACGGAAGTTCCTAGGTTAAGCAAGAGGTTAGGCTACGCTCGGAAGACCAAGGAAGCCTAAGCGTTACTAAGAAGGTACGGTACGTTCCTAAGTAGATCGACTAACTAGGAATAGGAGCCGCAACACAC
Strand-474	ACATCCAACACTCTACGCCCAGAAGAAGGAGTAACGAAGCCGCCGCGTTCGAACTAGAGAACTAAGAGAGGTAACCTCGAACGAGCGCCTCGACGTTAAGGAGCAAGTACGGAAGGAGTTAAGCGTCGTAGAGTAGCGGACGCTAACTCGAAGTCGCCGAAGCTCGAAGTAACAACGCGAGTAAGACCAAGAGGAGTTACGAAGAGTTAGAAGAAGCGAGACGCTAGAGAGAATAGGAGCCGCAACACAC
Strand-475	ACATCCAACACTCTACGCCCTTACTAACCAACAAGACTCGGCGGTTAACCTAAGCGAACGCCAACGCCAAGAGTACTCGCGCTACGTAGAGGAGTTCGAAGAAGGAAGAGAGGTAGTAAGCTCGCGCTAGCCTCGTCGCGTCGAGGAAGACTACCGTCGAACTCTCGAACGGAAGTAGTCTCGGACTCAAGAGCGCTCGAGAACAAGTCGTCGCGTAAGCCTAGTAGTCGGAATAGGAGCCGCAACACAC
Strand-476	ACATCCAACACTCTACGCCCTAAGGCGCTAACGCCTCGTTAAGAAGGAGAGAGTTAACCGTCGGCTCGACGACTACCGTCTAGAGGAAGAAGACGTAGGAAGACGCCTAGTTACTACAAGCTACGTAAGGCGTCAAGTTCGGACTCTACTAGAGCGCTAGTCTCTAAGTCAACGCGACGACTAGAAGGAACGCTAGGACGTACCTACTCGCGTACTAAGTCCTCGGCGGCGAATAGGAGCCGCAACACAC
Strand-477	ACATCCAACACTCTACGCCCAGAAGGAGTAACGAAGGAGACTAAGCGTAAGACAACAAGAGTCTACGAAGAGAAGCTCAAGGTAGCTCGAGACTCGGCGGCGCTAGACCTCGGACTACGAGAAGCAACAACGCGAGGCGGTAAGCTCCTCGCAAGTCGAAGAGACGCGGCCTACGAGGAACCTACGGTAGAACGACCGCTAAGAACGGACTAGAAGGACGCTCTCTACCTGAATAGGAGCCGCAACACAC
Strand-478	ACATCCAACACTCTACGCCCTTAACCAACAAGACTCTAGAGACGAGTTAGTAGGAAGCGACTCTAAGTACTCTCGGCGTCCTCTCGTAGGAAGAAGTCGTCGTCGAACCTAGTTAGACTACTCTAGACCTAAGCCTCGCTACTAGAAGTAACCTCGCTCGAAGACTCCGCCTAAGGTAAGGTCTCGGAGAAGTCGCCGTCAACTAAGGACTACGCAAGTCGAACTAACAAGAATAGGAGCCGCAACACAC
Strand-479	ACATCCAACACTCTACGCCCTACGAAGACGTCGGCTACCTAAGCAACGCCGAACCTCTAGAGACTCCTAGGTCGAACTACTCGAGGAGTTCGTAGAACGGCGCTCAAGTCGGCTCGACCTACTCGAGTAGTTCGTTCTAAGGTAGTACCGCGTTCGCCGTCTACGCTCGGTAAGAGAGGTAGTAACGCTAACAAGCTCTACAACTCCTAACGAACTAGAAGAACGGTTCGGAATAGGAGCCGCAACACAC
Strand-480	ACATCCAACACTCTACGCCCAGGAGTAACGAAGGAAGGTTACAACTCGTCTCGAGAACGAAGACTAGTACTAGTTACGGCTAGTTAACTAGCGCGTAACTCGAAGGAAGACTCCTAAGATCGTAAGACGCTCGCGTCGTCCGAAGAGAACAAGAGACCGAAGGTCTACGCTAGTAAGCGGAAGGTCTCTAAGAGTTAGAAGAGAGGTTAACTAACTACTACTCGACGACCGAATAGGAGCCGCAACACAC
Strand-481	ACATCCAACACTCTACGCCCACCAACAAGACTCTAACCTAGACGTTACTCCTAAGACTAAGAAGGACGAGTTAAGAGACTCGACAACTAAGAACCGCCTACGGCTCGACGACCGCTAGTACCTAGAGCCTCGCCGCTACTAAGACTCTCGCTCGATCGAGCCTACTCAACAACGGCGGAACGTACGCCGCTAGACTAAGGAAGTAAGGACTACTAGGAACTAGAAGTAGCGAATAGGAGCCGCAACACAC
Strand-482	ACATCCAACACTCTACGCCCGAAGACGTCGGCTACTAAGAACCTCTACGCCTACGCCTCCTCGCGACTCGCGCGACCGTTAGAAGAGAAGGCGTCAAGAGACAAGCCGGCGAAGACGAAGAGAGGAGCCTCTACTAGAGACTAAGGAACGTACCTAGTCTACTAACGTTCGCGACGTAGACCAACGTCGAAGAAGCGAGGTCGTAGTTCCTCGCGAGACTCAACGAACAAGAATAGGAGCCGCAACACAC
Strand-483	ACATCCAACACTCTACGCCCACTAACGCCTCGAGCGGAAGCTAGTACTAGTAAGGAAGCGTCAACTAAGCCGCCGCGAGGTCGTTAACTCTCGTCGGAGAAGGTTCGAGAGACCTCCTCCTAAGTTAAGCGAGCAACAAGAGAAGTAGAGACGCGAGCGTCGCCGGCTACTCGTTAGACGTAAGCCTCAAGTAAGTCCTAGACGCCGTTCGCGGAAGTTAACGCGGAGGTGAATAGGAGCCGCAACACAC
Strand-484	ACATCCAACACTCTACGCCCAGTAACGAAGGAAGGTTCTCGGAAGCTACCTCGAGAGACAAGAGGACGAGCTACTCGTAGAGCGCGTAACGAGAAGTCGCCGTAACCGCGAACTCGTAGTACAACTCGAGAGAGACTCCTAGTAGCTAAGACGGTAGAAGAGAAGGTACCGGACAACGAACCTCGAGCTAGGAACTCGCGAGGTAAGAAGGCCTAACTAGGAGGTTCGGAGAATAGGAGCCGCAACACAC
Strand-485	ACATCCAACACTCTACGCCCAACAAGACTCTAACCGTTCAAGAGTCGACCGCGTTACGACAACCTCGGAAGAGCTACGCGTTCCTCAACGGCGCTAGAAGGAGGAGCGCTAGGACCTAGAGTTCGTTCTAAGCGACGTTCCTAAGAAGCAACGCCGGAAGGTTCGGCGGCGGCCTACAACGCTCGACCGTTAACTCCTAACTAAGGACTAGTACTCCTCGTACGACCTCTGAATAGGAGCCGCAACACAC
Strand-486	ACATCCAACACTCTACGCCCAACGCCTCGAGCGGAGAACCTACTCAAGCGTAGAGGTAAGCGAGATCGTCGTTAAGTCTCAAGACTCGGTACGCCGTTCGAAGTTAAGCCGGTAAGTACAAGTAGAGCGGCGGACTACTAAGTTAGAGTCGGTTAGAACGCGAAGAGTAAGGTCGGTACGAACCTCGACTACAAGGTACGAAGAGTTCGTAGTTCAAGAGGTCGAGGTACGAATAGGAGCCGCAACACAC
Strand-487	ACATCCAACACTCTACGCCCAACGAAGGAAGGTTCGCCGGTAGTCGGACGGAACAAGCCGTTAGGTTAGAGTCGTAGAAGAGCTAGTCGACTAGTAAGACTCTCTCGTAAGCCTAGAGACTAAGACTCGTCTAACTACGACGCTCGACGAGGAAGAGTCGGAGCGTCGGTAGTTAAGAGAGTAAGAAGAGGTTAAGGAACCTACTAGAAGCTACGACTAGGACGTAGTTAGAATAGGAGCCGCAACACAC
Strand-488	ACATCCAACACTCTACGCCCAAGACTCTAACCGTTCAAGAGAACGGCGGAGACTCGAAGTTACAACGAACTCGCTCGTAAGCCTACAACGCTAGCGGACAAGGAACCGGTAGACGCTCGTAGAGTAGTAAGAACCTCGCCGAACTCGCGTTCGGAAGTTCGAGAACGACGACCGGCCTCGGAAGGCGGTAAGAACTCGCCGCGTAGACGACCGTACTAAGTAGGAAGTTAGAATAGGAGCCGCAACACAC
Strand-489	ACATCCAACACTCTACGCCCAGGAGCTACTAACGCGCGAGGAACGCTAAGAAGTTACGACGCAAGTAGAGTTCGACGAGCAACGCTCGGTAGACCTAGAAGACCTAAGCGTTCGAACTCCTCGTCGCGAACTAGTCGGAAGCCGGTACTAACAACAAGAGCTACAAGACGAACTACGTCGCTCTCTCGAGACTACGATCGAAGTACGCGTTACCTCAAGACGGTAGAACGGAATAGGAGCCGCAACACAC
Strand-490	ACATCCAACACTCTACGCCCGAAGGAAGGTTCGCCGGTAGTAACTAAGCGTCGACTCGAACCAAGACTAACGGCTCGTAGTACGCTCAACGATCGTTAAGGAAGTACTCGAACAACCTCGGCGGTACTCTCGTCAACAAGAGGACCTCGTCGACCTAGGAAGCGACTCCTCGGACCAAGTAACGAAGTCTACCTCCTACGACGTACGGCGGCTAACTAACGAAGTACGCCGAATAGGAGCCGCAACACAC
Strand-491	ACATCCAACACTCTACGCCCACTCTAACCGTTCAAGAGTACGCCAACCTCGAACCTAAGACGTAAGGCTAGTCGTACTAGAAGAACGCCGGCCTAGAGACGGAACGAAGTAACAACGCTACTACCTACTAGAGAAGTACCTCGGAAGGCCTCAAGAGTAGGAACGAAGAGTTAACCTACCGCGGTTAACGCGCGAACCGTCAACGCGCGAGATCGAACAACGTCGCGAGGGAATAGGAGCCGCAACACAC
Strand-492	ACATCCAACACTCTACGCCCAGCTACTAACGCGCGTCGAGTCGGACGTACGCTCGGTAGTCGACTCTAAGTTAAGGTCGGAACGAAGAACGCTAAGAAGTCGTCCTACTAACCTCGGAAGGCGCCGCCAAGGAACGAAGCAACCTACTCTAGTCGTTCTCGAAGTAAGTCGTCTAGTTCCTCAAGAGAACTAGAGAAGAGTTCGGTTAGAGCGGCGCGTAGTTCGTCTAAGAATAGGAGCCGCAACACAC
Strand-493	ACATCCAACACTCTACGCCCTCGAGCGGAGAACCTAGACGCAAGACCGCTCGAAGAGAGAGCGTCTAGACGACCGTCAAGAGTCGGTCGTTAACTACCAAGTAGTAAGGTAGCGCGTACTACTAGAGTTAGAGTAACGTCCTCGCCGCTACTAGCTAACTCTACGGAACCGCCTAAGAAGAAGGTTCGAGGAGTAGGTCGTAGACTCTAGAGAGGTAGAGTACCAACTAGGAATAGGAGCCGCAACACAC
Strand-494	ACATCCAACACTCTACGCCCAGAAGGTTCGCCGGTCTCGAAGTCTAAGTCGCGTAAGCCGTACTACAAGCGACGGAAGCTAAGACCTACTAAGAGAGATCGACTAAGAAGACTCGGTTCTAGTTCGGTCTAGAGAGTCGGAGCGAACAAGCGTAGAGACAAGAGACTAGGAGTTCGAGTAGTTAAGCTCGCGCCGGCGGTACGAGGACGTTACTACGCGGAAGTCGGTTAGAATAGGAGCCGCAACACAC
Strand-495	ACATCCAACACTCTACGCCCTTAACCGTTCAAGAGTTCGCTACTAGAGAGTAAGACTACGAAGAGAGTACGAGAAGGTCGGAAGGCGCTCGAACTAGGTAACGAGAAGCTAGCGCGTTCTCGACGACTACGAACGGCTACGGAGAACGCGTCAACTAGTAGAGCGAAGCCGGTTCGGAAGAAGGCGGTTAGAAGTAAGCGAGCGCTCCTAGGAGAAGCGGTCTCCTACTCGAATAGGAGCCGCAACACAC
Strand-496	ACATCCAACACTCTACGCCCTACTAACGCGCGTCGTTAACTCGCGGCAAGAGGACGAACAAGACTAAGGAACAACAAGACGCTCGCAAGACTACCTCGAAGTTCGGTAGGACTCAAGAAGCTCTACAACTCGGAACTAGCAAGTTCAAGTACTCGTACCAACGCGAAGTCGGACGCAACGGCTAAGGTACCAAGACTAGGAGTACGTTAGAGTAAGTCGCGAGACTAGTCGAATAGGAGCCGCAACACAC
Strand-497	ACATCCAACACTCTACGCCCAGCGGAGAACCTAGACCTACCGTAGAAGGCGGAGAACGAAGCTACTACGCCGGCAACTAGACGAGGAGCGGCGCGAGTAGCAAGAAGAGTACCAACGAAGGCTAGTTCTCGTACGCTCTCGTCCTACCTCGGTAGTAGAGCAAGTACCTAAGAGAGTCGACTAAGACCGTTCGAGACGGTCTAAGTACCGTCCGTTCGTCCGAACGTTAAGAATAGGAGCCGCAACACAC
Strand-498	ACATCCAACACTCTACGCCCAGGTTCGCCGGTCTCGGTAGACAACTCTAAGCCAAGAAGTAGACCTACTACTAACAAGCGTTAACGACGTTAAGCTAAGAGACCGTCGGCGAAGAAGTCAACGGCGTCGCTCTAGACTACAACTAACCTCTCGAAGGCCTCGGTACTCCTACTAACGAAGCCAAGTACTAGTACGCGACTAGACTAAGAGAAGGCGCGAGCGGTAGTACCGAATAGGAGCCGCAACACAC
Strand-499	ACATCCAACACTCTACGCCCACCGTTCAAGAGTTCAACCTCGCGACGTTCGCCGTCGGACGCGCCTACGCCAAGTCGAACCTAAGGACTAGTACTACGAGTACGAGTTACGGAGAAGAGAGCGAAGGTAAGTAAGGTCTAGAGAACTCGTTAGACTCGAGTTCGAAGAGCGGTAGCGGTCGGTACTCGACGACTAGTAGTACGTCGAGGTCGAACGTCTAGTAAGTCCTAGAATAGGAGCCGCAACACAC
Strand-500	ACATCCAACACTCTACGCCCTAACGCGCGTCGTTAGAGTTACCTCAAGCTACGAGGAAGAGGTTCGCGACCGTTCCTAAGACTCAAGTCCTAAGGTCGTTACGAAGGACCGCTCGGTTAGAGTCGTTCAAGTTCGTCGAAGACTAAGCTAAGAAGTCGACGAGACAAGACAACTACTCGAGACAAGCCGTTCTAGAAGACCAAGCCGGCGCGTACGTCTAGACCGTCGCCGAATAGGAGCCGCAACACAC
Strand-501	ACATCCAACACTCTACGCCCAGAGAACCTAGACCTCGAGAGTAGAGACTAAGGAAGTTCTACGGTAAGAGCGAAGGCCTCGGCGCTCGGTAGTTACCTAGGTAGAGTAGGAGCAACAAGAGGAGATCGTAGAGCTCGTTCGAACTCGGTTAAGAGAGCGGTAGAACTACCGGTAGGTACGTCTACCTCGAAGACGTCGCCGGATCGTTACAAGAACGCCTAGAGAACGGTGAATAGGAGCCGCAACACAC
Strand-502	ACATCCAACACTCTACGCCCTTCGCCGGTCTCGGTACGTCGGAACGCTACGCTCTCGCGACTACCGTCGGTAGAAGCAAGAGTACGTTCTCGTTACAAGAAGAACTAGAAGGTTAGTAAGAGGAAGCCAAGAGGTCGTACAAGACTCTAGACGCTAACGCCTAAGGCTAGGAAGGTAGCTACTACTACTAAGACGAAGAAGCTCTAAGTTAAGAGAGTAGGTAGAGACCTGAATAGGAGCCGCAACACAC
Strand-503	ACATCCAACACTCTACGCCCTTACAAGAGTTCAACTACTAAGAGAAGAGAAGAGACAACGCCGCTACTAGACTAACTCAACTCCTAAGGAAGTTCGAAGGTTAGTACTACGCGAGCAACGCGTTCCTAACGAAGTACGGCTCGAACCTACGCGCGACTAGTTACGGCGTCTACCTCGCCGTACTCGGAAGGTTCAAGTAGTACGTCGCCGTTCCTAGTAGCGCTCGAGCCGAATAGGAGCCGCAACACAC
Strand-504	ACATCCAACACTCTACGCCCGAACCTAGACCTCGATCGAGTTAAGCTACCTAACCTCGGAAGTAGAGAGAGAGTAGTTAAGGCTAAGGCAAGAACGGACTCTAGGCCTCGACGGAAGGTCGGACCGCGTACCTAAGACCTCGCTACAACGCTACGTTAAGCGAAGAGACCTCGAACTAACTAAGGAAGTACGGAGAACGCAAGAGCGCTCAACGCAACGGAAGGTAGTTCGAATAGGAGCCGCAACACAC
Strand-505	ACATCCAACACTCTACGCCCACCGGTCTCGGTACGAGACGCTCGAGTTAGGAAGTCTACTAGAGTCTCGGTAGGAACTACTAAGTCTCGACTAGTAGGAAGACCGCGACCGTCGAAGACGTCTAGAGTCTAACGAACTCGAACGGACAACCTAGCCTCTAGACGAGAAGACAAGCGAACTAAGAGTAGACGAGCTAAGGATCGAAGTAAGGCGTCCTCGTCGAACTAGACGAATAGGAGCCGCAACACAC
Strand-506	ACATCCAACACTCTACGCCCTAAGAGTTCAACTACCTCGAAGCGAGAGAGTTCAAGTCGAGGAGACAAGCTAGCGCCGGTCTCGGTAGGACTAGCGTCGAAGGTAGTCTAAGCGGTAGTAGGTAACGCTACCTAGAACTCCTAGACGCCGCTAGTCTAAGTAGGAACGCCGGAACTAGAACGAAGAGAAGGTTACTAAGTTACCTCGGTCGGTACTAAGACGTCTAACCTGAATAGGAGCCGCAACACAC
Strand-507	ACATCCAACACTCTACGCCCACGTCGTTAGAGAGCCTCGGTAGCGAAGAAGTCAAGTAACCTCCTACTCTCTCGAGGACCAACGTCTCGTACGCTCTCGAACGCAAGAGACTCAAGGAAGCTCGAACTAGAAGACGCTAAGCCGCTAAGACCGGACAACAACAACGAGAGACTAGGAACCTCGGTAAGAAGACGTAACTACAAGCCTCGTAGTAACGAAGGTTAAGAACGGAATAGGAGCCGCAACACAC
Strand-508	ACATCCAACACTCTACGCCCTACGGACCTCGATCGTTCAAGAGGACCAACGTCTACGAAGCCTACGGAAGTAAGGAACCTCGGAGGAGCGGTCTAAGGAGACGCGTCGCTACTACGTCGAGAACTAGACTAACGAACGCCGGAAGACGCTAACCTCCTAGAGACTACGCCAAGAGCTAAGCTCTACGCGAAGAAGCCGGTTCGACTAAGAAGTAAGCCAAGTAAGAAGTCGAATAGGAGCCGCAACACAC
Strand-509	ACATCCAACACTCTACGCCCAGTCTCGGTACGAGACTACTAGAGACGTTCGAAGCCGCCTAACCTCTCGCCGGAGAGTCGTCGAAGAGACCTAGGACGAGCCTCGGATCGTCGTTCAACGCGAACTACTAAGCCGTTAGTAACCTACGACCTCGAAGGAGTTCGACTCAAGGTTCGGAACGCGGTACGTTAAGCGGACTCTACGCCAAGTAGGAAGGAACTCTCGAACGTGAATAGGAGCCGCAACACAC
Strand-510	ACATCCAACACTCTACGCCCAAGTTCAACTACCTCTAGAACGGAGACTACAACGGACGCGGAAGGAGCAACAAGGAAGGACCTCGGTAAGCTAGACTCCTACTAACTCCTCTCGAAGAAGGAGAAGCGAACGGAAGTTACTCGTTAGAAGCCGCCGTTCGAAGCGGTCTAAGGTTAAGCGGTCTCGGTTCGACTACGTTAGAACCTCGGACCGAAGGCGAACGAGACTACGAATAGGAGCCGCAACACAC
Strand-511	ACATCCAACACTCTACGCCCTCGTTAGAGAGCCTCGAAGACCTAAGCGAAGGTAAGAGAACCGTACGAACGACTCCTCTCTCGAAGTAGTTCGCGTCGACCAAGAGTAGCTAGAGCAACTACGGCGGTAGGACGAACTCGACTAACAACGGCTAACGACGCGAACTAAGAGAGACCGCGAACCAAGTCGCCGCGAAGTTCGCTACGTTACTACGCGCGACCGAACAAGCCGAATAGGAGCCGCAACACAC
Strand-512	ACATCCAACACTCTACGCCCAGACCTCGATCGTTCGCTAAGTACTAGACCGGCTACGGCGTCAAGAGCGTCTACTAGAGTAGAACTCTCTACTAGAGCGAACCTAGCGGAACGTTCTAAGCTACGAGGCGGTAGACGACGAGCGAAGCCGGTCGGTAAGACTCGAACGCCGTAAGAAGCAAGTACGCGTCGTCGTACGGTAGGTAAGAGAGATCGTAAGTCGCCGGCGTAGAATAGGAGCCGCAACACAC
Strand-513	ACATCCAACACTCTACGCCCTTCGGTACGAGACTAAGTTCGAGTCGGACGTTCTAAGCCGCTACGTCGACGAGGAGAAGTTACGGCTCGAGCTAGTAGTACGCTCCTAGTAGTAGAGAACCTAGGAGTAGGAACGGAGACAAGGAAGAGAGGTACGTCGGAGAAGTCGCGAGTTAGGAAGGTTCGTACAAGAGCTCGTAGGAAGAAGTCAAGAACGGCCTAACGAGTAGGGAATAGGAGCCGCAACACAC
Strand-514	ACATCCAACACTCTACGCCCTTCAACTACCTCTAGAACTAAGCCAAGAGACGCTAAGGAAGCGGTAACGTCGCTAGAAGCTACGCGAGTAGTCTCGTCAACAAGACCGTACGCCTAGACGGCGTCTAGAACCTAAGCGGACAAGGAGAGTAACGAACCGAAGCTACTAGCAAGTTCGGTTACGGCGGAAGTCGGACTCTCCTACGAAGAAGGTAGAGAGAGTAGACCTAGGAATAGGAGCCGCAACACAC
Strand-515	ACATCCAACACTCTACGCCCTTAGAGAGCCTCGAAGAGGAACTCGAAGGCAACCTACTCGGTACGACTAGACGCAAGAGTACTCAAGAAGAGTTCTACAAGAACGGAAGCCTCCTACTAACCGTTCTCGGCTACGGCGGACTCTAAGGTAACCTACTAGACGCCGAACTAAGCGCTACCGGTAGGTAGAGCCTCGTCCTAAGGTAGAACCTAACGTCGTACGGCGCTAGCGAATAGGAGCCGCAACACAC
Strand-516	ACATCCAACACTCTACGCCCTACTCGTCGTTCGCTCGAAGCTAACCTACTAACCTAGACGTCGCCGAAGGCGCCTCGTACTCGAAGTTACGCCTACTACGCGGCGGAACCGTACTAACTACTCTCAAGACTCGGAGAGAGTTAACTCGGTTCAAGAAGTAGAGTTACGCTCAAGACCTCAAGTCGAACGCGAGGAGGTAGTAGTCGTAGTACGCTCCTCGCGGTAAGAGGGAATAGGAGCCGCAACACAC
Strand-517	ACATCCAACACTCTACGCCCAACTACCTCTAGAACCTCGTCTCGTAAGAGACGTACTCGTAGTACCTCTACGGAAGGAGTCTAAGAGACTAGAACGTCTAAGCCGCTAGTACTCGGACCGGAGAAGGCAAGACGAACAACCTACGCTAGACTCTCAACGGATCGAGCTAGTTCGGACAAGAACTAACGTAGGAACTCCTAAGTAACAACGAACGAAGGAGACGCTACGGAGAATAGGAGCCGCAACACAC
Strand-518	ACATCCAACACTCTACGCCCAAGAGCCTCGAAGAGTTAACTACGACTAGTAACGAACGCGGTACGACTACTCGACAAGAGACGACCAACTAGACTACTAGCGGACTAGAAGACAACTAAGCCGTACGCTACGCCGGATCGAACGGTACGGAACGATCGAAGTACTCGGAAGGCTAAGAGGAAGTCGCTAACGCGTCGTCGGAACAACCTAGGTACTACGGACTAAGGACTGAATAGGAGCCGCAACACAC
Strand-519	ACATCCAACACTCTACGCCCTCGTCGTTCGCTCGACCTAGTTACAACGGCGCCAACGTCTAAGCTACCGGCCTAAGTTACTAACTACGAAGTACCGTTACGTACGGTAACAAGAGAGAACGAAGAAGCGAAGACCTCAACCTAAGGCGGACGAACTAGAGTCGGAGTAAGTACGGATCGACCTACGCTAGAAGAACCGGCGCTAAGACCGCGAACCTCGAAGAAGAGTCGGAATAGGAGCCGCAACACAC
Strand-520	ACATCCAACACTCTACGCCCACGAGACTAAGTAGAAGCAAGAGTTAGGAACAAGACCTCAACGCGACCGCTACCGGTTAGTTCTACGAACGAAGAACCGAACCTACGAGAGACTCGACGACCAAGACTCTCCTAAGCAACGTCTCGAAGAGAAGTAGGTACAACGAAGAGACTCTACTCGAACTCGCCTAGAGCCTAGACTCGAGAACGAGTTAACTAACGAGGAACGGTGAATAGGAGCCGCAACACAC
Strand-521	ACATCCAACACTCTACGCCCTACCTCTAGAACCTCGTCTCGAACTAACTAGAGTAACCTAGCGGTCTACAAGAGTCGTAAGCGTAGAGGTAGACCTAGAGAGAAGGCGTCGCCGCTCGGAACGGTAGGACGTTAACCTACTAACTCTACGGCGAACGACAAGCCGTAAGTTAAGGACCTCAACGTCTCGGTAGTTAACTCTCGAGATCGAGCTAAGTCGAACTAAGCGAAGAATAGGAGCCGCAACACAC
Strand-522	ACATCCAACACTCTACGCCCAGCCTCGAAGAGTTAACTCGGACCGAACGAACTCGCGGAAGAAGAAGCGAAGCCGGCTACGCTCTAAGACCTACGACCGCCTAGTCGTTACGCGGCGAAGCCTCGTACGCGTAAGCGAAGAACCTACCTAAGTAGTTAAGCGTCTAGAAGAGATCGTCGTTAGAAGCTAACGCTACTCCTCCTAGACTCGCCGCCTAAGACGTTACTCCTGAATAGGAGCCGCAACACAC
Strand-523	ACATCCAACACTCTACGCCCTCGTTCGCTCGACCTAGCGGTCTCCTAACTCGGAGTAACCTCGGCGGAAGTCTAAGAGAGTACCTACGAAGCTACGGATCGTTACTCGGCCTCGGACCTCTCTAACTAGGAGAGACCTACGCCGCCGTACCTCTAACGTTAAGTACTCCTACGACTACCTACGTCGTAAGCGGAAGTAACAAGACGGAAGACAAGAACTACGGACCTAGAGAATAGGAGCCGCAACACAC
Strand-524	ACATCCAACACTCTACGCCCAGACTAAGTAGAAGCTCGAAGTTAAGTAGCTAACCTAGAACCGTTCGAGAGACTCGAACCGTAAGTACCGCCGCCGCTAGTTACGGACCTAACTACGGACTACTAAGACCTACGTAACGAGACTAGGAACCTAGGTACCTAAGAACCTACTACGCTCGGAACGTCAAGACCGGCCTAAGGACTCTCTAACGCGGTAGGTAAGAGAAGACGGAATAGGAGCCGCAACACAC
Strand-525	ACATCCAACACTCTACGCCCTTCGAAGAGTTAACTCCTCAACGCTAACGCGGAGACGGTACGACGAGAAGAAGACTCTCGAGAAGTTAACAAGACCTACCTCGCGAAGTCGCCAAGTTCTAACTCTAAGCTCGAGAGAACGGTACGGAAGAGTCGTTCCTACCTACTCTACGAAGTAGTAGTCTCGGCGAAGCGTTCAAGAGCGTCGAACCTCCTCGCTCGACGAGACCTGAATAGGAGCCGCAACACAC
Strand-526	ACATCCAACACTCTACGCCCTTAAGTAGAAGCTCGTCGTAACAAGCGGAAGACGCTACCTCGAACTCGACTAACAACTCGACGAGGACCGGTTACGGTACTAGCAACTACCTCGGTACGTTCGGCGGAGAACGCGTCTACGCCGGCAAGTAGGAAGGAACTAAGTTCGGAAGTAGGTACGCCAACGAAGGCGCCGCCGTCGCCAAGTACTACGAAGACAAGTAGCGGTAGGAATAGGAGCCGCAACACAC
Strand-527	ACATCCAACACTCTACGCCCTAGAACCTCGTCGCGAGACAACGAGACGGAAGCTAGTAAGTCGCTACTCTAAGCGTCTCGTTCAAGTTCGCCTACGGAACTACTAACGAAGACGTCTAGAAGACTAGAAGGTTAAGTACCTAACGCGCTAACGGACTCTAGACCGAAGAACTAAGGAACGTCGTCTACTCGAACTCGTAGGAAGTCTACTACAAGACGTAGAGGAGAACTGAATAGGAGCCGCAACACAC
Strand-528	ACATCCAACACTCTACGCCCGAAGAGTTAACTCCTCTCGAACGAAGAAGTACTCCTAACTAGAGGAGCAACTACTCGAGAGAACCTAAGTACAAGTAAGGTAGGAGCTCGAGCTAGTAACGAGACAACGGCGCCGCTAGGAACCTAACTAGGTACGCTCGAGACGGTCTAACTCGACGCCTCGGTAGCGCTCGCGCCGGCTCGAAGTAAGGCGCTAGCGAAGCGAAGAAGGAATAGGAGCCGCAACACAC
Strand-529	ACATCCAACACTCTACGCCCACTCGACCTAGCGGCCTCGGTTCGGAAGGTACCGGCTAGTAGACTAGAACCTAGTACGTCAAGAGACTCGGTAGCGTCTCGTTCGGCCTAACTCTCCTCAACTAGTACTAACAAGAGACGACCGGTAAGAACGGCCTAAGCGGCAAGTTACCTCAAGAAGACGCCGGCGCTAGAGACGCCGTCGGTAGTACTCAACTAAGTACTCCTAGAGAATAGGAGCCGCAACACAC
Strand-530	ACATCCAACACTCTACGCCCAGTAGAAGCTCGTCGTTCAACGCGTACGGTCTAGACAACTCGTAGAGACGCCTCTACAACGTCGTCCTACGACCTCAACGAGAAGGCAAGTAGTACGGCGTCTCGAACGGACTAGAGACTAGCGGACTCAACGGCCTAAGGAGTACTAAGACGGAAGCCGAACTCTACGTCTAAGAGTTCTACTAAGGAAGCGCCGGCAAGTTACTAACGGAATAGGAGCCGCAACACAC
Strand-531	ACATCCAACACTCTACGCCCAACCTCGTCGCGAGACTACCTAGCGAACTACTCCTCGGCGCGGAAGTCAAGTTAACCGTCGAAGAAGGAACGGAAGCCGTTAGGAAGACCTAACCTCAAGACTACCTCTACGCCAACTAAGCGTAAGTCTCGACGACTAGTAGTTAAGAAGAGTTCGCTAAGACCGTCAACAAGAGTAGCTAGTCGAGCCTACGAGAAGCGAGTTAAGAGGAATAGGAGCCGCAACACAC
Strand-532	ACATCCAACACTCTACGCCCAAGTTAACTCCTCTCTAGAGCGTCAAGAGCTACGGCTAGAGCCTACGACCTCGGAGGAAGGAAGACTCGACGAGAAGCTACGAACGACCTCGCAACCTCGAAGACGCCTAAGTCAACGTCAAGTACGGAACGACTAGGTTCTCGACCTAAGTCGCGAAGTCGACGACGACGAACTCGACCTACGCGAGCGCTAGAGAACCTACCTAGAAGGAATAGGAGCCGCAACACAC
Strand-533	ACATCCAACACTCTACGCCCTCGTACGGCGGCCTCTAAGTCGCTCTCTCGTACCTAAGTAGTTCGACTCAACAACAAGTCGCTCAAGCTCGGTAGAAGACGTTAACCTAGACGTCGTAACGAACTCGGACTCAAGGTTAAGTCGTCGCGAACGGCGGCGGCTAAGCTCCTCCTAGAGAAGGAACTCGGAGTTAAGCGGAAGCGTTCGGCGTCTCTAGCTCGAGGACGGAAGAATAGGAGCCGCAACACAC
Strand-534	ACATCCAACACTCTACGCCCTTCGTCGCGAGACTACCTAGCAACGGTTACGCGTTACCTCGGTAGTCGTACGCTAAGTAACAACTAACTACCGGCGCCGCCGCCGGCGTCGCTAGAACCTACGCGAACAAGTCGTTAACGAAGAGAAGTCTCTAAGTCTAGAGGTCGGAACAAGGTCTAGAGAGTTAAGGAAGAGAGTAGAGAACCGGCCTACTAAGGAGACAACTAAGGGAATAGGAGCCGCAACACAC
Strand-535	ACATCCAACACTCTACGCCCTTAACTCCTCTCTAGAGCCTAACCGCTAGCGGTTACTCGAACTAAGGCTACGGACCTCGGTAAGGTTCGAGAGAGAGGACTAAGACTCTCCTCGGCGCTAAGACTACGAAGACCGTCGTCGTCTAACTACTCCTAACGACGACTCCTCGCGGAGAGAACTCGTTCGAAGAACGAGAGAAGAAGTACTACGCTCTAACTCGGAGCGTCGGTGAATAGGAGCCGCAACACAC
Strand-536	ACATCCAACACTCTACGCCCTACGGCGGCCTCTAACGAGACCTCAACTAGAAGAGGTACGCCGGTTAACAACTAACCGTCCTAGACTACCTCAACGCCGCGAGGAGAACCTAAGACTACGCTCAAGAGTACGGCGCCAAGAGTAGTACCGGTAGGTCGACCGCCAACCTAACCGCGTTACTCGGATCGAGTAACCTAGCCGTAGTAACTACGACGAAGTACGCGAGGTTAGAATAGGAGCCGCAACACAC
Strand-537	ACATCCAACACTCTACGCCCAGCTCGTCGTTCGCGACGTAGTAAGCGTACGGCGGCGAAGCTCCTACTAGGACGTCGTAAGAAGGTCGGTAGTTCGTCTCGACCTCGAAGAGTAAGTTCGCCAAGTTAGAGTTACAAGGCGCTCGGTTAAGGTAGTTACGCTACTACAAGAGAGAGAACAAGAGCGGTAGGAAGACGAACGCTACGAAGTTAAGTAGGACTCCTCTCTCGGAATAGGAGCCGCAACACAC
Strand-538	ACATCCAACACTCTACGCCCACTCCTCTCTAGAGCGAACTAACGAGCAACCTCCTACGCAAGACTAGGACGTTCAAGAACGCTCTCAAGACTCGGAAGTACGGAACGAGGACTAGAGAAGCCGGCTACCTAAGTCGGACCTCGACGACGACTCAAGACTAAGAAGCCGCTCTCTCGTACGCTAGTTACTAGTTCCTAACGTAGACTAAGAACGGCTAGTAAGGCGCTCGCGAATAGGAGCCGCAACACAC
Strand-539	ACATCCAACACTCTACGCCCAGCGGCCTCTAACGAACCTACTACCTCGGACTCGCGAGATCGTTACAAGAGTACTACGAAGCCTCGACCGCTACGACGGAACGAAGGTTAACTACGTAAGCCGCTACGAGCGCCGCCGTAGAGTCGTTCCTACGAAGACTCAAGAACCTACAACGAACTACTCGAACTAACAACGTCTACTCGACGACTAGTAGCGGCTAGAACTAAGAAGAATAGGAGCCGCAACACAC
Strand-540	ACATCCAACACTCTACGCCCACGAGACTACCTCGCGCGTAAGAAGCCTCGACTCGGAAGAGCCTCTAGTACCTCTAACTACCTAGCGAAGCCTACAACCTCGGTTCGTTCCTCGCCGGTCTACAAGACCTCTAGAGGACTCGCGCCGGCTAGAACAACTAGTTCGAAGTCTAGTAAGAGAGTAACGAAGGTTAGTCGTTACTAACTAGTAGTACCGGTACTAACGTCGGCGAATAGGAGCCGCAACACAC
Strand-541	ACATCCAACACTCTACGCCCTACCTCTAGAGCGAACGCGGAACTCTCGCTAGTACCAACTCGAGAGAGTAGTTCGCTCTCGAAGTCAAGTACCTCGCGTACCTACTCGCGCCTAGGAGGTAAGGTTCGTCGAAGTCGAGCTCGTTAAGGAACGTCGTCGCGGAACAAGACGCGTTCAACAAGAAGGAAGAGACGAAGAGAACGTTACCTACCGAACAACTCGCGAGGTAAGAATAGGAGCCGCAACACAC
Strand-542	ACATCCAACACTCTACGCCCTCGTTCGCGACGTAAGCTAGCCTCGTCTAGACGAGCAACGGAGAAGGCGTCGTCTAACTACGCGAAGCGAGACAACTACTAGAAGGAAGGACCTACAACGGTAAGGAACGAACCTAAGGTAACGGACAACCTACGAGAACCGAAGAACGACAAGCGGAACTCTCGAACGGTACGACCGTAAGGCGGTCGACCGAACTCGGAGACGCTAGCGAATAGGAGCCGCAACACAC
Strand-543	ACATCCAACACTCTACGCCCAGACTACCTCGCGCGAGCTCGTTAACTAACGCGTAACGACCTACGAGGAGCGTCTCGAGGCGGTTCGCTAGCCTCGGTACCGCCGAAGGTTAGAGCAAGTAGTACGGTAGTAGGTAACAAGACGTCCTCGGCTAGAAGACTCGGTTCTCGTAAGAAGGTAGACAAGCGACTAACGTCCTCCTAGACCGTCTAGAAGGTCGTAGACGCAAGGAATAGGAGCCGCAACACAC
Strand-544	ACATCCAACACTCTACGCCCTTCTAACGAACCGAAGCTCGACGCGGTTCGGAACTACGAAGCGGAAGTACTACTCAAGAAGAGGAAGCGAGCTACAACAACGGTTCGTTCAACGCTCCTCGCCTACTCGGCTACGAACCTAGCTCGACTAGAAGGACTACTCGCTACAAGTCGAAGTTCGCCAACTAGAGTTCGAAGAGGTTCTAGACTCGACTCGAAGCTAGCGGACTAGAATAGGAGCCGCAACACAC
Strand-545	ACATCCAACACTCTACGCCCTTCGCGACGTAAGCTAGTTAACTCTAAGGAAGGAGACAACTACGAGACCTACAAGAACGCGGCTCGTTCTCGAACAACGCCGTAACGTTAGACGGTAGCGGACAACCTCGGTAAGTCGCCTAACAAGAGAGTTACGGTTCGACGAGGTTAACCGGTACCGGTCGGAACGGTCTAGAGTACTAGAGATCGAGCGCTAGGTTACGCTACCTAGAATAGGAGCCGCAACACAC
Strand-546	ACATCCAACACTCTACGCCCTTACCTCGCGCGAGCAAGTAACAAGCGAGGACCTCGTAGAGCCTAAGAGAGACTCAACTAACTAGTCTAAGTAAGAACGAAGGCGTCAACGTCTCGAGCTACTCGACCGCGAGTACTCGGACGTACGCCGTTAAGAGTTACTCGTTAGACTACGTCGGAAGTAAGAGACAACTACTCAAGACGACGTTCGCCTAGACTCGAGACTAAGGTGAATAGGAGCCGCAACACAC
Strand-547	ACATCCAACACTCTACGCCCTAGAGCGAACGCGTCTCGTAACGACAAGCGAACAAGTAGAGCTAGACGTAAGGAAGTAACGGAACCTAGAAGAGTCTAACGTAAGCTAGTACGTACCTCGTCGCGACCTACCTCGGCAACGCGACCTCGACCGCCGTTCGGACCTCGGCCAAGTTACCTCCTCGGAGTAACTCGTTACTAAGCTAAGGAAGAAGTCTCGAAGTCAACCTAGAATAGGAGCCGCAACACAC
Strand-548	ACATCCAACACTCTACGCCCTAACGAACCGAAGCTAGAGAACGACCTAGCCTCTAGTTAAGTTAAGGAAGTTAGAGTTACAACGGTCTCTAGACGAACGAACGAAGGAGTAGCGTCAAGGAAGGCCTAACTACCAACTACGGATCGAGCCTCCGCCTCGGTTACGGAAGACAAGCCGCGTTAAGTACCGTTCGCGTCTAGAGTACTCAAGACGGAAGCGCGAAGACCTACGAATAGGAGCCGCAACACAC
Strand-549	ACATCCAACACTCTACGCCCACGACGTAAGCTAGTCTCGGTTCGGAAGAAGGCGAAGGTCTCGAAGACGGTAGTCTCGGACAACTAACCTAACTACTCAACGCCGCCGGAAGCGAAGAGTTCCTCTAACTCGCCGCCGTTCGACGCGCGTACGAAGTCTAAGCCTACAACGAACCTAGACGCGGCGGTAGGAAGACCGTCTAGACCAAGAGGTTCTCCGTAACTACTAGTGAATAGGAGCCGCAACACAC
Strand-550	ACATCCAACACTCTACGCCCTACTAGACGAGCAAGTTCAACGCGACGTAGAAGACCGGACGCTAAGCGGAAGGAAGTAGTAGGTAGTACGTCGGCGGAAGACCTACTCGATCGACGTCGTTCCTCTACGAACTAACGACCGTCGCTAGCCTCAAGTACGCGAGGCGGCGGTCGTACTACTACAAGAAGAGGACTAGTCGGAACGCGTACGAACGTAGAAGCGGTAGACAAGAATAGGAGCCGCAACACAC
Strand-551	ACATCCAACACTCTACGCCCAGCGAACGCGTCTCGTTACCTAGCCTAAGGTAACTCGTCGGAACCAACTAAGAGGAACGCGCCGCCGGAGAACGAACTCTCCTCCTAAGTTCGAGTTAACCTAGGACCTACTAGTTAGACGCCTAAGCTCAAGAGTAAGAAGGTCTAGAACTAACCGGTCTACCTACGAAGAGTAGACCTAACTACAAGTACGCCGTACTCGCCTCGTCGGAATAGGAGCCGCAACACAC
Strand-552	ACATCCAACACTCTACGCCCTCGACCGAAGCTAGACGCGCCGGAACTCCTCAAGAGAGAACCGGTCTCGGTCGGACGTCGACCGCGGAAGGTAGGACGACGAAGAGTAAGTAGGAACAAGACTAACGAACTCGGAGAGACGTCGAACCTCGGTAACGATCGAGACTACAAGAAGAACTCGGTTCGAAGAGCCTCGCCGTAAGGAAGTTCAACTAGTTACTCGGTCGTACCGAATAGGAGCCGCAACACAC
Strand-553	ACATCCAACACTCTACGCCCACGTAAGCTAGTCTCGAAGAACTAAGGAGAACGGAACCTACTCTAACCGTAACTCTACAACTCCTCCTCCTCGAACGCGGACAACCTAGTCTACTCCTACCTACTAAGAACCAACTCGGTACCGCTCGGCGGAGGAGCGGTCTCGGCGTCGCCGCTCCTCGATCGTAAGCTAGGCCGAGTTAGTTCGCCGTAAGCGTAGTAAGCCTCAAGGAATAGGAGCCGCAACACAC
Strand-554	ACATCCAACACTCTACGCCCTAGACGAGCAAGTTCGCCGCCTACTAGTCGGAAGCGAGGCGGTTAAGAAGTCTCGTCGGAACCTAAGGCCTAGAACGAAGTTAGTACAAGAAGGAAGTCGGAACGAGAAGACTCTAACTAAGGTTCTACAACGCTCGCTAGTTAAGTAGTTCGAGGACCGGTAGACTCGAAGGTACGTTAACTAACCTCCTAAGAAGAACCGTCCTCTCGGAATAGGAGCCGCAACACAC
Strand-555	ACATCCAACACTCTACGCCCGAACGCGTCTCGTTAGAAGGACGCGAAGAGAGCGAACAAGCGGAAGCGTAAGAGGAACGACGCGGTTAAGGCCTAACGAACGCCAAGTTACCTCGCTAGTACGGAGACTAAGTCGGCGAAGAGTAGTTACGCTCGACCGTCTCGACTAGACTAAGGTTCTAGACTACCTAGACGTACTCGAGAGAAGGCGGCGCCTACGAAGGCAACTAGGAATAGGAGCCGCAACACAC
Strand-556	ACATCCAACACTCTACGCCCACCGAAGCTAGACGCGCTCGACTCCTCGCCGTACCTCGACAACCTAAGTAGAGCTACCTCCTCTACTAAGGACTACCTAGCGGAACCGTAACGACCTAGTAACGAAGTACTAGTTAGTAGGAAGGAGAGGAAGAAGCGGAACGCAAGACTACGAAGTCGACGTAAGCCGCTAGTTAGGAACTACTAACGTACGTCAAGAGGACCTCGTAAGAATAGGAGCCGCAACACAC
Strand-557	ACATCCAACACTCTACGCCCTAAGCTAGTCTCGAAGGTAGACTACTAACCTAGAAGTAACTCTAAGACTACGCTACTCCTCGCGGTTAAGAAGCCGCTCGCGCTAGGAGAAGCGAAGACGTCTCGACGACTAGCAAGAACCTCCTCGCCAAGAGAAGTTCGTAGGAACCTCGCGCGTTCGCCTCGACGTCGTAAGCGGAACGCGGATCGAACGTCGTCTAGAACGGAGAAGAATAGGAGCCGCAACACAC
Strand-558	ACATCCAACACTCTACGCCCTAGAGGTCGTTAGAAGACGGAAGGCGGACTCGAAGTAGTCTAAGAGACGCTCGAGAAGGTAGTTACGGAGACTAGAGGAGGACCGTAGAACTAAGGAGCCTCGGCGCTAGTTACTAGAGGAGTCGGACCGCTAACCTCGTCTACCTACTCCTAAGTTACTAAGCGTCGACCGTCGAAGCCGGTCTAACTCGACTCAACGAAGTCTACTAAGAATAGGAGCCGCAACACAC
Strand-559	ACATCCAACACTCTACGCCCGAAGCTAGACGCGCTAACGTCAAGAGTAAGTACGCTAGTAGAGAAGGCCTCGGACGCGCTAGAAGCGCCTACCTACAAGGAGACGCTAGGAGAACGTTAACCGTTCGGAGACTAAGCAAGTTCGTCGGAAGTACTCAACTAAGGTACGGAAGCTAAGGTAACGCCGCCTACGCGAAGAGAGAACGACAAGGTAAGGAAGGTAGAACGAGAGAATAGGAGCCGCAACACAC
Strand-560	ACATCCAACACTCTACGCCCACTAGTCTCGAAGGTAACGGTAGACTACTACTAGAAGCCGAAGAAGAACTAACCTAGTAACGAACCTAAGGTCTCTAACAAGGTTCGTTAGAAGGAAGCAAGACGTACGCCGCGAGTCGGAGTTAGAGGACTACGAGACGCGCTACCGCTCGACGCGTCGCTCAAGCTCTACTCGGCAACGCCGTTACCAAGACTACTAACCTCTAGAAGGAATAGGAGCCGCAACACAC
Strand-561	ACATCCAACACTCTACGCCCAGCAAGTTCGCCAACAAGAACCTAGACGGAACCGTAAGTCTAAGAGAAGCGTAAGACGCTAGAGAAGGCGCCGGATCGACCGTTAGTCGGACGAGTCTCGTCGCGTTAGAAGCGAAGTTAACTAGTCGGAGGACCGTTCCTCCTAAGACCGCTAGTAGCGGACTCGCTACGAAGAGAGGCTCGAGTTCGTCGAAGAGAACCGTACAAGAGGAATAGGAGCCGCAACACAC
Strand-562	ACATCCAACACTCTACGCCCAGGTCGTTAGAAGACGTCTAGAGCGCTACTCAACGCAACTAGACTCGAAGCTCGTAGAGTCGGAGACGCGTCAAGAGGAGTAACGTCCTAGAACGCTCGAGAACCTAGAGGAGCGGAACGTCGAGGTCGAACCTCGGACTCAACGTCAACCTCAAGTTAGACGCTCGGAGGCGGACCTAGTCGAGCGTCAAGTTAAGTACTAGGAACGCTGAATAGGAGCCGCAACACAC
Strand-563	ACATCCAACACTCTACGCCCAGTCTCGAAGGTAACTAAGCGACTCTCCTAACGAGCGTCTCGACTCTAGAACTAACTCTAAGGAAGACGAGGTTAAGGTCGTAGTAAGACGCTCAAGCGTAACAACTCCTAACCAACTAGAGTACTACCAAGAACTACTAACCTAGCGCCGGAGAGTTAGACTAGTAAGGCTAAGCGGAAGACAAGAGTACGAAGTAACAAGAAGCGACTGAATAGGAGCCGCAACACAC
Strand-564	ACATCCAACACTCTACGCCCAAGTTCGCCAACAAGACGAACTAGTAACTAGAACTCTACGGACTAGAACCTACTCTAGACGGCGGCTACTACGCCAACGGACTACTCTAAGTCAACTCGTTCGTCTCGTTCCTACCTCTCAACGGACTCTACTACGGCGAACGACGCGCGAGCGTCAACTACGGTACTAGAAGGAGTAGACCTCGCTAACTAAGAAGTTACGAAGAAGGTGAATAGGAGCCGCAACACAC
Strand-565	ACATCCAACACTCTACGCCCTCGTTAGAAGACGTCTACAAGGAAGCGTCGAGACCTAAGTAGTAAGCTAAGTAAGGAGAAGGTTACTAACGCGTCTACGGAACTACTAGGAAGAACGCCTCGTAACGAGACTCGTAACTACGACTCGGTTACGGTACGTTACGCCTAGAAGTCAACAACAACAAGTTACTACCTCCTCGAGAACGAGAAGTCGCGGAAGGACGCTCTCCTGAATAGGAGCCGCAACACAC
Strand-566	ACATCCAACACTCTACGCCCAGACGCGCTAACGCCGGTTCGACTCGAGAGTAAGGAAGGAGGTTACGAACCGCTACGTAGTAGAACGGAACCGAAGCTAGTAAGTTACCTACCGAAGCGGAACTCTAACTCTAAGGAGAACGCGCTAGCTACGCGTCGAGGAGCTCGTAACAACTAGACGGCGGTCGGAGTTCGAGCGAAGGTACCTAACAAGTCCTCTAGAACTAGACCGAATAGGAGCCGCAACACAC
Strand-567	ACATCCAACACTCTACGCCCTTCGAAGGTAACTAAGACGCGAGTCTCAACAAGAGCCTACTAGACTAAGCTCGGAGTAGCGCGTCGTACGGAGAAGACCTAACCGCTACGTAGACCGCCGTCGGCGTCGTCTCGACGTAAGGTCTAGAGTAAGAAGCGAGACGCTCGACCGGCGCGTTACAACAAGCCGGCAAGGAAGGTAGGAAGACCTCTACTAAGGCGAAGACTCTAGAATAGGAGCCGCAACACAC
Strand-568	ACATCCAACACTCTACGCCCTTCGCCAACAAGACGAACAAGACCGGCTACAAGAGTAGACTACCTCTCAACTAAGACGCCTAAGTCGGAGAGAGGAGGACGACCGCGTTCAAGAGTCTCTCGAAGTAGAGGAGTACTAACGTCTCGGAAGAACGCTACGGAAGCCTCGCTCAACCTAGCGTCGCCGCGTAGTAAGGAGAAGAAGCGTTCTCGTTCGTCGGTTCGTTAGAAGAATAGGAGCCGCAACACAC
Strand-569	ACATCCAACACTCTACGCCCTTAGAAGACGTCTACAACCTACTCGGCGGCGTCTAAGGTAGGTAACAAGGCTCGTTCGGAAGGTAGTCGTCGTAGACCAACTCGAAGAGCGGCGCTCTCTAACGCCTCGGTAGCTACAACGGTTCGACTACTAGGAGCGCGACTCGAACTAAGAGAAGCGCGAGGAGGTAACGCTAGAGCTAAGTCGGAGAACTAACGTAACTACTAAGCGAATAGGAGCCGCAACACAC
Strand-570	ACATCCAACACTCTACGCCCTAGACTAACGCCGGTAAGAAGTAAGCCGCTCGACGCCTAGAACGACTACGCGGAGACCTCGGCCTCTAGTAAGAGACGAGGAACCTCGTCGCGAGCGAAGAACAAGTCTACTAGTCGAGCGCCGTTCTAGACGAAGGCCTAAGAACGACGACCGTCTAGAGTTAAGGCTAACTAGAAGCCAACGGATCGTTAAGCTAAGGACAAGCTCCTGAATAGGAGCCGCAACACAC
Strand-571	ACATCCAACACTCTACGCCCGAAGGTAACTAAGACGTCCTCTCGTAGGAAGCGACCTAGAACCAAGACCTCTAACTCGGAACTAGAACCTAGTTCGTCGAAGGAGACGAACAACGCGTCGGTAGGACGTTACTCGCTAGCTAGAACGTCAAGTTCAAGAGAACCGGCGAAGCGTACGTCGCCGCCGTCGGTTAACGAACGAGTTAAGGTACTAGTAGGTACTACTAGAGCGAATAGGAGCCGCAACACAC
Strand-572	ACATCCAACACTCTACGCCCACCAACAAGACGAACGCCGTCTCGAAGGAACGACTAGACGCCGGTCGGAGAAGCGGAACCGTAGAGTTACCTAAGACGACCGCGTAAGACTACAAGAGGAACTCGTTCGCCGGACAAGAGAGGTACGTCCTACAAGCCGAAGAGTAGAGTAGGAGACAACTCGGAGAGTTCTCGACGAAGTACTACCTCGCTCTCGTCCTCCTAAGCTCGGAATAGGAGCCGCAACACAC
Strand-573	ACATCCAACACTCTACGCCCGAAGACGTCTACAACGAAGCTACGACTACCAAGAACGTCGAACTAGACGAAGCGTACTACCTCGCTAACGGTAGAGAAGCGACGAGCAACTACGCCAAGTCGTTACTCGCTCAACGAGGCGGACCTCGGCGGACGAGTAGGTACAAGAGGAGCGCCAAGTAACCTAGACCTAGAACTCCTACGACCTAAGACAAGTACTAGGAAGCCGTAGAATAGGAGCCGCAACACAC
Strand-574	ACATCCAACACTCTACGCCCACTAACGCCGGTAAGACTACTAGCAACAACTACCTCGCCGTAACCTACTCGAAGTAGAAGTAGTAACTACTAAGGTCGTCGAACTAAGAGTACCTACAAGAGAGTAAGACCGCTCGAGAACGCCTACCTACGGAAGACTAGTCGTCGAAGAAGTTAGAAGGCTACTAGAACAAGTTCGGTAGCGAAGTCGGTAGTAACGGTTAGAACGGTGAATAGGAGCCGCAACACAC
Strand-575	ACATCCAACACTCTACGCCCAGTAACTAAGACGTCGGTAGCGTCGGACGCGTCCTCCTCGAAGACGGTAGTTCGTCGAGGTTAAGGACTAGAACCGCCGGTAGTCGGTACAACGGCGGTTACGCCGGAACTCGCGCCGAAGGAAGCGGTTAAGAAGAAGACGCCGTTCGCCTCGGCCTCAACTACAAGAGGTAACGTTACTAACAACCGAGAGAACGAAGACTAAGAACTGAATAGGAGCCGCAACACAC
Strand-576	ACATCCAACACTCTACGCCCAACAAGACGAACGCCAAGTTAGAGTAGAGCGCTCAAGCGGAAGACGGCTACTAAGCTAGGTAACGAACGTAAGCTAACAAGAGGTCGAGCGCGGAAGGACTAAGGCGGAGGTCGAGGACCGGTAACTAAGCTCGCCTACTAGAAGGCGCCGTCCTACAACTAAGGACGTACAACTCGAGAACCGTCGGACAAGGCGCCGGTACGTACTACGAATAGGAGCCGCAACACAC
Strand-577	ACATCCAACACTCTACGCCCAACGTCTACAACGAACGACCTAGGAGAGAAGAAGGAACTCGACTCCTCGCGGAACAAGACAACTCGAGAGACAACGTCGTCGGCAAGAACAAGTAGTAAGGATCGAAGTAACTACGAAGACTCGCGTAAGGTACCTCGACTAGGACCGTACGCTAGAGTAGCGCGTTACGAAGGACGGAACCTAGTACTAACGCTCAACGCGCCTCGACGGAATAGGAGCCGCAACACAC
Strand-578	ACATCCAACACTCTACGCCCAACGCCGGTAAGACTAGAAGTACTACGAGGACTCGCTACGTCGAAGGCGTCTCGTAAGCTACCGTTCGGAAGAGCGAAGGACTCTACGCGAGTCTAAGTTCGTTCTCGAGTTCGAGGAGGTCGTTCGGCTACAAGCCTCCTCAAGCGAACGGTAACCTCGTCGCGAGTAGCTAAGAGACCGTACAAGAGTACGCGTTCAAGAAGAACCTAGAATAGGAGCCGCAACACAC
Strand-579	ACATCCAACACTCTACGCCCAACTAAGACGTCGGTCTCAACGGTAACCTCGGCGCCTACGAAGGACAACGAACTAACGCTAACTAACAACCTACTCTAAGACCTCGAGAGAGCTACAACGGAAGCGCTCTCAAGGAAGACAAGTACGAAGTCTAAGAGGAAGACTACGCTCGAGAGAGAAGGAAGACCGCCGGTAAGTCGTTCGTCGAACTAGAGTTCAACTAGACTAGAGAATAGGAGCCGCAACACAC
Strand-580	ACATCCAACACTCTACGCCCAAGACGAACGCCAAGTTAGAGAACGGTAGGTTACTCGCTCTCTCGTTCTACGTCTACGGCAAGGAAGACGGAGACGGTAGTAAGTTCTACGGTCGGCGGTACAACGCTCGCGCGACCGAAGCGAGGACGAGTACTAGAACCTCGTTCGGCGCCTCCGTAAGAAGTAACCTAAGTACGAGTCTACGCGCCGTACGGTAGACGTACGTAGAAGAATAGGAGCCGCAACACAC
Strand-581	ACATCCAACACTCTACGCCCAGGTACAACGAACGACCTAGGAACTACGGAGACGGAACCGTCTCGTTCGGAAGTACGACTACCGAACAAGGACGCCTCTCGAGACGCGTCTCGAGCGGCGCCTCGAACTAAGCCGTTCTCCTAACGAAGAGTCGGTACGCTAGTTAAGACGGCCTACGACCTACTCGGAAGAACTACGCCAAGTAGAGTAGACCTAACGGTAGCTAGTTAGAATAGGAGCCGCAACACAC
Strand-582	ACATCCAACACTCTACGCCCACCGGTAAGACTAGAAGTACTAACGAAGTCGGAACCGAAGAGGAAGAGAAGAGCCTACTACCTCTACCTACTAACTAGGAAGACGTCAACGTCAACGGCGGTTAACGAGACGCCGGAAGCGGAAGACCTACTAGACTACAACAAGCCTAGTTACGAAGCTAGTAGTAAGGTACTCGCGGAAGCAACGTCGCCTAGAACGCGAACGGACCTGAATAGGAGCCGCAACACAC
Strand-583	ACATCCAACACTCTACGCCCTAAGACGTCGGTCTCAACGGTAACAACTACTAGAAGAGTAGGTCGTAGAGCGCTCGAGAACCTAGTAGCTACGGAGACTCGACGACGAGATCGACGGAACTCGCTCGGAGTCGGACTAGTACTCAAGTCTAGAGAAGTCTAGACTAGAAGAGCAACTAGTTCGAACAACTACCTAGAGAGTCGACCGGCTACTCGAACTCGTAACAAGCTGAATAGGAGCCGCAACACAC
Strand-584	ACATCCAACACTCTACGCCCACGAACGCCAAGTTAGAGTACGCCTACGTCGCCAAGACGTACTAGAAGAAGTAAGAAGGCGTCTCGTAGAACTCGTACGGCCTCCTCGCTACCGGCGTCCTCAACTACAAGACCAACAACAAGAGTTACTAAGAGACCTCGAAGAGGAAGTTCGGCGGCCTCTCGTACCGTTACGCGTAGAGTACCGCGACGACCGGTAGAGACTCGACTGAATAGGAGCCGCAACACAC
Strand-585	ACATCCAACACTCTACGCCCTACAACGAACGACCTCGAAGTCGGTTCAACGCTAACGAACGCAAGACGACTAAGAGTAGGCGGAGAAGCGAAGGACCTAGGAACCTAAGGAGAGAACGCGCCAAGACGAGCTAGTTAAGCTAACTCAAGAGTACGTTCGTCGTCGAAGGTAGTAGGAGCGAACGGAGGAGTACTAGCGGAGACTCGAGGAGAACGACTACTCTCGCTAGTGAATAGGAGCCGCAACACAC
Strand-586	ACATCCAACACTCTACGCCCAGTAAGACTAGAAGTAGACGCAAGTTCCTAACTACCGCCGGACTAAGGTTCTAGAGCAACGAAGCCTACGCGAACGAACGCAACGGTACTCAAGCGTTCGTCGCTACCTACGGCTCGAGTACCGTAAGAAGAGAGAGTTCGACTCCTACCGCTCAAGAGACCGAACGCTACAAGACCTCGTCGTAACGAGAAGACTAAGCTACCTAGAAGGAATAGGAGCCGCAACACAC
Strand-587	ACATCCAACACTCTACGCCCAACGCCAAGTTAGAGTTACCTCTACTCGAACGACCTCGGACTACGTAAGGCGCCTCGTAAGAAGCGACCGAAGCTACTCAAGAAGAGTTAGAAGGCGGACTCAAGAGAAGTTACTAAGGACCTCCTAGTAAGTTCAAGTCGTAGTTAGACAACGGTAGCGCTAGGAACGCTCGACCTAAGTCGACTAGAGACGCTCGAACCGCTAGTACGGAATAGGAGCCGCAACACAC
Strand-588	ACATCCAACACTCTACGCCCAACGAACGACCTCGACGCGGCTACTAACCTAGGAGCAAGACCGGCCTCGGCGAAGCTCGGTAAGAGTTACTACCTACTACCGCCTAGAACTAAGCTACCTCGACCAACGAACAAGAACCTCTACCTACGAGTACTAGGACCTAGTACTAACTACCTCAAGACTCGTAGTAAGACGTCAAGAGTACGAGGTTCTACGGCTACGCCGTACGAGAATAGGAGCCGCAACACAC
Strand-589	ACATCCAACACTCTACGCCCAAGACTAGAAGTAGACAACGAAGTCTAACCGGTCGGCGGTCGAGAAGCTACTACCTAGAGTAGAGACAACGCTAGTTAGAAGACCTCGGTACCGCGAGCTAGTCGGAAGGACAACGATCGTTCGCGTACGTCGCGTTAACGTCGTACTAAGACTAAGACGGACTCGGAGACTACTCGTACCTCCTAGAGAGTAGACTAGAGTACGCCGTAGAATAGGAGCCGCAACACAC
Strand-590	ACATCCAACACTCTACGCCCAGGAGTCTCAACCTCGCGAGAGACTAGACGAGGAGTAGGAGCTAACTACGCGCCGGACTCGCGTTCAAGTTACTCGGTACCGCCTAGTCGAGAGTTAACAACCTCGGAAGCGCCGAACTAAGTAGCGGCGCTAACGGCGAAGAAGCCGAAGCCGTCTAGACGGAAGAACCTCTCTAACGATCGAAGAGAGAAGCTACGTAAGGTTCTCGAGAATAGGAGCCGCAACACAC
Strand-591	ACATCCAACACTCTACGCCCACCAAGTTAGAGTTACCTCTAGACGCCAAGAAGTTAACGTAAGACGGTAGGAGGAGAAGGCGGTCGACCGTCAAGAGCGGCAACGCGAGGAGGAACAACTAAGCTAGCAACGAAGCTCAAGGTAGTTAGAGCGTCGGAAGTCTCCTACGAGAACTCGGCAACTCGGAAGCGGAACAACTCGTTCGAACTAGTCGGTTAAGCAAGGAAGGAGAATAGGAGCCGCAACACAC
Strand-592	ACATCCAACACTCTACGCCCGAACGACCTCGACGCGGCTACAACGGCTAAGAGTTAGAGTTCGCGACGAGCTACTAGTACTAGAGGAGTCTACTACCTAAGAGCGAACTCTAAGAAGTCCTACGCGAACGCTCGTCGACGAGAAGTACCGGCTCGAAGTTAAGAACGTCGTAAGCCTCGACCGAACGAGAAGGAACCGCGGAAGCGAACTCGTACCTCGAAGACCTAACTGAATAGGAGCCGCAACACAC
Strand-593	ACATCCAACACTCTACGCCCACTAGAAGTAGACAACGAACTACCTAGTAGAAGTTCTAGACTCTCTACGCCTAACGCGCGAGTAAGAGTAAGAACGTCTAGAGTCTCGAACGCGAAGCCTAAGGCTAGACTAGGACTAGTAACGGCTAAGTCGGCAACGCCGCTAGAGTTAACTCGTTCTACAACGGCCTAACCAACGGTACCGGAAGAAGGACCGCCGGTACGAGTTAAGAATAGGAGCCGCAACACAC
Strand-594	ACATCCAACACTCTACGCCCAGTCTCAACCTCGCGACGAGTCGGTAACTAAGTCGGTAGAGAGAAGCTCGATCGTAAGGTCTAGACCTCTCGTAAGCTAGGAGGAGTTCGAGAAGTTAGAGTTAGACGAGTAAGAGAGAGAGGTACTAAGCGTACTAGAGCGCGAGGTCGTTACCTCAAGGTCTAAGAAGGTAGTCGTAAGCGAGTCTACGCGGCCTCGCGTACAAGAAGGAATAGGAGCCGCAACACAC
Strand-595	ACATCCAACACTCTACGCCCAAGTTAGAGTTACCTCGCTAGAAGAGACAAGAGAGTTAACGCGCGTTAACCGGCTCGAGTAGGTTAGAGAGCGGTACGGAAGCCAAGAGTTAAGGTCTCGGCGCGAGCCTAGAACGAAGCTAACTCTAGGAAGACAACGGACGCGCGTTCGGCCTCGGAACCTAGTCGACGAGACGCGTAAGAACGTCGTCGACTAGTCTCGCTCGAACCGAATAGGAGCCGCAACACAC
Strand-596	ACATCCAACACTCTACGCCCTCGTACTCGTAGAGCTAAGAAGTCCTAAGGAGTAACGGCTACCTCGGCAAGTACGCTCGCGTCGGCGGCCTAAGTTCGAGTCTCGGAGAGAGAAGGAGACTACAAGTCTACGCGAAGTTAACTAACAAGTCGTAAGGCCTCTAGAGTCTACGACGCAACTAGAGATCGTTCGCGAGTAGGAACAAGAACTCGTTCTAAGTCCTACAACAAGAATAGGAGCCGCAACACAC
Strand-597	ACATCCAACACTCTACGCCCAGAAGTAGACAACGAAGAACTACTCGGTCGTAAGTCGGACTACAAGGACGCGTCTAAGACAACAACTACCGACAAGACTACCTCCTCTAGTAAGCGTAACAACGCTCGTAACAAGGCGCTAGTAGTTCGTACGGCTAAGCCGTACGAAGTACGGAAGTCAACCTAGAGTTACTCCTCTAAGAGGAAGCGTTACGCCTCTCGACGAAGGACGAATAGGAGCCGCAACACAC
Strand-598	ACATCCAACACTCTACGCCCTTCAACCTCGCGACGTTAAGTAGTTAACGCGTCGGAAGAAGTTACAAGACTCGACAAGTCCTAAGTACGGAAGGCCTCGTCAACGCTAACGCGACTCTCAACTCGTACGAACAACGAAGTAGCTAACTAACCGCTCGGAACGGCTCGTACGGTAGGAGACTAGAGAAGACCGTTCTCGAACTCAAGTCGGAACTACGAAGAACCGCGAAGGAATAGGAGCCGCAACACAC
Strand-599	ACATCCAACACTCTACGCCCTTAGAGTTACCTCGCTAGTAGACCGTTAGCGGACTAAGTCTAAGTTAGAGGTTCGAAGGTTCGTTAAGCGAACTACGCGCCGGCTACCTACTCTCGAACGGAGACGCGAAGAGCGCTCGGTTAGACGCTAGCAACAACGGTTAGTAGTTCGTCGGAGACGCCGGTAGGAAGAAGTCGAACCTCAAGTAGGAACGAAGTCTCGTCCTCGTCGAATAGGAGCCGCAACACAC
Strand-600	ACATCCAACACTCTACGCCCTACTCGTAGAGCTAACAAGCGTTCGCTAGGTTAAGAGAGTTAAGCTACGCCGTCGCTAACTACGGCAAGAGGAGTCTCGGCGGTTACCTACTCTCGAGCGAAGAACTAACCGCTCTACGAGACGGTAAGTAACTACTACCTAGGTCGTCGGAACGCCTCGGTTAAGTCTCGAAGTCGAGCGTCCTACAAGCCGAACTCGCCAACAACCTAGAATAGGAGCCGCAACACAC
Strand-601	ACATCCAACACTCTACGCCCAGTAGACAACGAAGAACGAAGTAAGGTCTACCTCTCGCCTCGAGCGGCGCTCCTCGAAGAGAGAGGCGGAGCCTAACTCCTAGGACGACGAGTAACTAAGCTCTCCTCGTCAAGAACCTCTAAGAAGTCGTCGGTACTCGACAAGACAAGTAAGGACTCAACTACGCGAACAAGAGATCGAGGTTCGCTAGTACCGGTTACTAAGGCGCGGAATAGGAGCCGCAACACAC
Strand-602	ACATCCAACACTCTACGCCCAAGTTACCTCGCTAGAGCCTAACGAGGAACAAGACTAGAACGTAGAGCTAAGGTTCGTTCCTCAAGACTCCTCGGACGTCGACCGGACTCTCGTAGTAAGGCTAAGCTCCTACGACGAAGAACGGACTCCTCTAAGGTAGTAGGTACGCTACGAGAACCTCGTAAGAAGACTAACTCAAGTCGAGTAGTAACGGCGTCAACCTCGCGAAGGAATAGGAGCCGCAACACAC
Strand-603	ACATCCAACACTCTACGCCCTCGTAGAGCTAACAACGACCTCCTCCTAAGACTAACGTCCTCAAGACCGCCTCGAGTACCGTAACGGAAGAGAGTTAAGGACTAACCGGAACCTAACGAACTAACAACCTCTAAGCTCGGAAGTACCTACGCTAGTCGACCAACAAGTAGACCAAGAGAGACGGTTCGTTCTCGTAGTACTCGTTAAGCTCGTACCTACAAGAAGAAGCTGAATAGGAGCCGCAACACAC
Strand-604	ACATCCAACACTCTACGCCCTTCGCGACGTTACCTCTCTCGAACCTACGCAACAAGTCGACGTAAGAGAAGGAACAAGAGTTCGCGTAACCTAGGAGGAGGAGCGTCGGTAGACAAGCCGGAAGGTACGAAGGAAGGACTACGAGTAGCGCGACGTTCGGAAGTACCTACAACGAAGAACGACAAGGACTCTAGAGCGCTAGGTACCTAGAGAGAGAAGAGGAAGTCGTCGAATAGGAGCCGCAACACAC
